ライフハックス||life hack; life hacks
ライフ・ハック||life hack; life hacks
ライフ・ハックス||life hack; life hacks
ペニスバンド||strap-on dildo
ペニス・バンド||strap-on dildo
巨大ガス惑星|きょだいガスわくせい|gas giant
ガスジャイアント||gas giant
ガス・ジャイアント||gas giant
成人女性|せいじんじょせい|woman; adult female
逆レイプ|ぎゃくレイプ|reverse rape; sexual assault by a female of a male
ヴォータン||Wotan (god in German and Anglo-Saxon mythology); Wodan
ウォーダン||Wotan (god in German and Anglo-Saxon mythology); Wodan
ウォータン||Wotan (god in German and Anglo-Saxon mythology); Wodan
辺獄|へんごく|limbo
プラシーボ効果|プラシーボこうか|placebo effect
プラセボ効果|プラセボこうか|placebo effect
偽薬効果|ぎやくこうか|placebo effect
微量要素|びりょうようそ|micronutrient
微量養素|びりょうようそ|micronutrient
ハーフトラック||half-track
ハーフ・トラック||half-track
挟射|きょうしゃ|ejaculation during a mammary intercourse; titjob cumshot
狭射|きょうしゃ|ejaculation during a mammary intercourse; titjob cumshot
太陽系小天体|たいようけいしょうてんたい|small solar system body
衆参|しゅうさん|House of Representatives and House of Councillors; both houses of the Diet
幕を下ろす|まくをおろす|to come to an end; to lower the curtain
幕を降ろす|まくをおろす|to come to an end; to lower the curtain
幕をおろす|まくをおろす|to come to an end; to lower the curtain
幕を下す|まくをおろす|to come to an end; to lower the curtain
喪に服する|もにふくする|to go into mourning
爆誕|ばくたん|sudden emergence; sudden formation; coming out of nowhere; bursting onto the scene
ロケット燃料|ロケットねんりょう|rocket fuel
菱目打ち|ひしめうち|stitching chisel; pricking iron; multi-prong punch for leather-craft
陶盤|すえざら|ceramic plate
陶皿|すえざら|ceramic plate
喉風邪|のどかぜ|a cold in the throat; common cold with a sore throat
のど風邪|のどかぜ|a cold in the throat; common cold with a sore throat
ガルバニ電池|ガルバニでんち|galvanic cell; voltaic cell
ガルバーニ電池|ガルバーニでんち|galvanic cell; voltaic cell
どう考えても|どうかんがえても|surely; clearly; without a doubt; in all probability; no matter how one slices it; no matter how one looks at it
考えもつかない|かんがえもつかない|unthinkable; unimaginable; inconceivable; unclassifiable; never dreamt of
考えも付かない|かんがえもつかない|unthinkable; unimaginable; inconceivable; unclassifiable; never dreamt of
身動きが取れない|みうごきがとれない|unable to move; dead in the water; completely helpless
身動きがとれない|みうごきがとれない|unable to move; dead in the water; completely helpless
六十進法|ろくじっしんほう|sexagesimal; base 60
鼻にかかった|はなにかかった|nasal (voice); twangy
鼻に掛かった|はなにかかった|nasal (voice); twangy
バビロニア数学|バビロニアすうがく|Babylonian mathematics
からすれば||judging from; on the basis of; from the point of view of
からしたら||judging from; on the basis of; from the point of view of
どない||what kind; what sort; how; in what way
宇宙斥力|うちゅうせきりょく|dark energy
死に方|しにかた|way to die; means of dying
死に方|しにかた|quality of one's death
ガルバリウム||Galvalume (brand name); Galvanium; steel with an Al-Zn coating
ガルバニウム||Galvalume (brand name); Galvanium; steel with an Al-Zn coating
鼻にかかる|はなにかかる|to speak through the nose; to nasalize
鼻に掛かる|はなにかかる|to speak through the nose; to nasalize
パイスラ||woman with a diagonal strap between her breasts (shoulder bag, set belt, etc.)
パイスラッシュ||woman with a diagonal strap between her breasts (shoulder bag, set belt, etc.)
睡眠学習|すいみんがくしゅう|hypnopaedia; hypnopedia; sleep-learning
反知性主義|はんちせいしゅぎ|anti-intellectualism
ミルクガラス||milk glass (opaque glass, usu. white)
ミルク・ガラス||milk glass (opaque glass, usu. white)
セルフプロデュース||emphasizing one's good qualities; presenting oneself in a favorable light
宇宙項|うちゅうこう|cosmological term
ナースシューズ||comfortable low-heel shoes, suitable for nurses
ナース・シューズ||comfortable low-heel shoes, suitable for nurses
陶|すえ|ceramics; pottery; porcelain
軌道上|きどうじょう|in orbit
ケグ||keg
スケグ||skeg; skegg; skag
プッシュバック||pushback (e.g. aircraft); push-back
プッシュバック||resistance; objection
エアステア||airstair
堆|たい|bank (river, lake)
浅堆|せんたい|bank (sea, ocean); shoal
水先案内人|みずさきあんないにん|(boat) pilot
バーベット||barbette
バーベット||barbet (variety of dog)
巡洋戦艦|じゅんようせんかん|battle cruiser; battlecruiser
装甲巡洋艦|そうこうじゅんようかん|armored cruiser
水雷巡洋艦|すいらいじゅんようかん|torpedo cruiser
防護巡洋艦|ぼうごじゅんようかん|protected cruiser
ミサイル巡洋艦|ミサイルじゅんようかん|missile cruiser
艦種|かんしゅ|class of warship; warship category
係留施設|けいりゅうしせつ|mooring facilities; moorage; berthing facility; berth
ベイランダー||bilander; billander; bélandre
国際信号旗|こくさいしんごうき|international maritime signal flags; international signal flag
旗旒信号|きりゅうしんごう|flag signaling; flag signalling
バウスプリット||bowsprit
民主的平和論|みんしゅてきへいわろん|democratic peace theory
電磁的|でんじてき|electromagnetic
エントロピック重力|エントロピックじゅうりょく|entropic gravity
修正ニュートン力学|しゅうせいニュートンりきがく|modified Newtonian dynamics; MOND
リボザイム||ribozyme
ループ量子重力理論|ループりょうしじゅうりょくりろん|loop quantum gravity; LQG
小紋河豚|こもんふぐ|finepatterned puffer (Takifugu poecilonotus)
コモンフグ||finepatterned puffer (Takifugu poecilonotus)
彼岸河豚|ひがんふぐ|panther puffer (Takifugu pardalis)
ヒガンフグ||panther puffer (Takifugu pardalis)
軍鳩|ぐんきゅう|carrier pigeon; war pigeon
ネップ||NEP; New Economic Policy (Soviet Union, 1922-1928)
やり出し|やりだし|beginning; outset; start
やり出し|やりだし|bowsprit
遣り出し|やりだし|beginning; outset; start
遣り出し|やりだし|bowsprit
クリスマスマーケット||Christmas market
クリスマス・マーケット||Christmas market
クリスマス市|クリスマスいち|Christmas market
コリスチン||colistin
性愛文学|せいあいぶんがく|erotic literature
ストックキャラクター||stock character
三幕構成|さんまくこうせい|three-act structure (in screenwriting: setup, confrontation, resolution)
暗黒エネルギー|あんこくエネルギー|dark energy
アベニーパファー||dwarf pufferfish (Carinotetraodon travancoricus); Malabar pufferfish; pea pufferfish; pygmy pufferfish
アベニー・パファー||dwarf pufferfish (Carinotetraodon travancoricus); Malabar pufferfish; pea pufferfish; pygmy pufferfish
コンゴ自由国|コンゴじゆうこく|Congo Free State (1885-1908 name of the Belgian Congo)
卓球部|たっきゅうぶ|table tennis club; ping-pong club
醜婦|しゅうふ|ugly woman; unattractive woman
温泉旅館|おんせんりょかん|inn with hot spring facilities; hot spring inn
自律的|じりつてき|autonomous; autonomic; self-sustaining; self-directed
情報過多|じょうほうかた|information overload
警保局|けいほきょく|Home Ministry Police Affairs Bureau (1876-1947)
内務省警保局|ないむしょうけいほきょく|Home Ministry Police Affairs Bureau (1876-1947)
街道筋|かいどうすじ|highway route (Edo period); main route
都大路|みやこおおじ|avenue in the capital; busy main street of the capital; main thoroughfare
台屋|だいや|caterer in a red-light district
台の物|だいのもの|food set out on a stand; gift placed on a stand
台の物|だいのもの|food brought on a large stand to a brothel by a red-light district caterer
作業台|さぎょうだい|workbench; work table
郊外化|こうがいか|suburbanization
理解の範疇を超える|りかいのはんちゅうをこえる|to go over one's head; to be beyond one's comprehension
建ち家|たちいえ|house; building
建家|たちいえ|house; building
建家|たてや|house; building
損者三友|そんしゃさんゆう|three kinds of harmful friends: hypocritical, sycophantic, and glib-talking ones (Confucius)
損者|そんしゃ|bad acquaintance; person whose acquaintance will be harmful
損友|そんゆう|bad friend; friend with disadvantages
対酌|たいしゃく|sitting across from each other and drinking together
対飲|たいいん|sitting across from each other and drinking together
口腔液|こうくうえき|oral fluid
アトメートル||attometer; attometre
ピコメートル||picometre
フェムトメートル||femtometer
メチレン青|メチレンあお|methylene blue
月経過多|げっけいかた|menorrhea; hypermenorrhea; epimenorrhagia; profuse menstruation
過多月経|かたげっけい|hypermenorrhea; menorrhagia
ヴィラネル||villanelle
トランプゲーム||card game
カジノゲーム||casino game
カジノ・ゲーム||casino game
バカラ||baccarat (card game)
テキサスホールデム||Texas hold 'em (poker game)
テキサス・ホールデム||Texas hold 'em (poker game)
クラップス||craps
ロッテリー||lottery
キノ||keno (casino game)
キノ||kino (gum, resin)
キノ||kino (cinema)
クレサラ||credit card and consumer financing
ビデオポーカー||video poker
ビデオ・ポーカー||video poker
牌九|パイガオ|pai gow (Chinese gambling game)
牌九|パイゴウ|pai gow (Chinese gambling game)
有毒動物|ゆうどくどうぶつ|poisonous animal
灰色後家蜘蛛|はいいろごけぐも|brown widow (Latrodectus geometricus); brown button; grey widow; brown black widow; house button spider; geometric button spider
ハイイロゴケグモ||brown widow (Latrodectus geometricus); brown button; grey widow; brown black widow; house button spider; geometric button spider
ラトロトキシン||latrotoxin
波布水母|はぶくらげ|habu jellyfish (Chironex yamaguchii); habu-kurage
波布海月|はぶくらげ|habu jellyfish (Chironex yamaguchii); habu-kurage
ハブクラゲ||habu jellyfish (Chironex yamaguchii); habu-kurage
ユーシャンベルジア||Euchambersia (genus of therocephalian therapsid)
喇叭雲丹|らっぱうに|flower urchin (Toxopneustes pileolus)
ラッパウニ||flower urchin (Toxopneustes pileolus)
博戯|はくぎ|gambling game; game of chance
博戯|ばくぎ|gambling game; game of chance
ちんちろりん||chirping; twitter
ちんちろりん||pine cricket
ちんちろりん||pine cone
ちんちろりん||cee-lo (dice gambling game)
チンチロリン||cee-lo (dice gambling game)
取り立て屋|とりたてや|debt collector; bill collector; repo man
白髭海栗|しらひげうに|collector urchin (Tripneustes gratilla)
シラヒゲウニ||collector urchin (Tripneustes gratilla)
滑々饅頭蟹|すべすべまんじゅうがに|floral egg crab (Atergatis floridus); brown egg crab
スベスベマンジュウガニ||floral egg crab (Atergatis floridus); brown egg crab
棘紅葉貝|とげもみじがい|sand sifting starfish (Astropecten polyacanthus); comb star
トゲモミジガイ||sand sifting starfish (Astropecten polyacanthus); comb star
トビズムカデ||Chinese red-headed centipede (Scolopendra subspinipes mutilans); Chinese red head
アトランティックシーネットル||Atlantic sea nettle (Chrysaora quinquecirrha); East Coast sea nettle
濠太剌利海蜂水母|オーストラリアうんばちくらげ|sea wasp (Chironex fleckeri)
オーストラリアウンバチクラゲ||sea wasp (Chironex fleckeri)
天草水母|あまくさくらげ|Amakusa jellyfish (Sanderia malayensis)
天草海月|あまくさくらげ|Amakusa jellyfish (Sanderia malayensis)
アマクサクラゲ||Amakusa jellyfish (Sanderia malayensis)
アンボイナ貝|アンボイナがい|geography cone (Conus geographus); geographer cone
アンボイナガイ||geography cone (Conus geographus); geographer cone
埋扇蟹|うもれおうぎがに|Zosimus aeneus (species of poisonous crab)
埋もれ扇蟹|うもれおうぎがに|Zosimus aeneus (species of poisonous crab)
ウモレオウギガニ||Zosimus aeneus (species of poisonous crab)
鉤手海月|かぎのてくらげ|clinging jellyfish (Gonionemus vertens)
カギノテクラゲ||clinging jellyfish (Gonionemus vertens)
岩隠子|がんがぜ|black longspine urchin (Diadema setosum)
雁甲蠃|がんがぜ|black longspine urchin (Diadema setosum)
ガンガゼ||black longspine urchin (Diadema setosum)
岩隠る|いわがくる|to die (for a nobleman)
イルカンジクラゲ||Irukandji jellyfish (Carukia barnesi)
サインポール||barber's pole
サイン・ポール||barber's pole
天皇陵|てんのうりょう|tomb of Japanese emperor; Japanese imperial burial site
泥棒政治|どろぼうせいじ|kleptocracy
泥棒政治家|どろぼうせいじか|kleptocrat
クレプトクラシー||kleptocracy
失敗国家|しっぱいこっか|failed state
紛争ダイヤモンド|ふんそうダイヤモンド|blood diamond; conflict diamonds; war diamonds
資源の呪い|しげんののろい|resource curse; paradox of plenty
後発開発途上国|こうはつかいはつとじょうこく|least developed country; LDC
知識経済|ちしきけいざい|knowledge economy
チェリーピッキング||cherry-picking
チェリー・ピッキング||cherry-picking
ポリアンナ効果|ポリアンナこうか|Polyanna principle; Polyanna effect
豊饒の角|ほうじょうのつの|cornucopia; horn of plenty
豊穣の角|ほうじょうのつの|cornucopia; horn of plenty
おとり商法|おとりしょうほう|bait and switch; switch selling
囮商法|おとりしょうほう|bait and switch; switch selling
リアリティ番組|リアリティばんぐみ|reality television; reality TV show
レイライン||ley line
レイ・ライン||ley line
地電流|ちでんりゅう|earth current; telluric current
新三種混合ワクチン|しんさんしゅこんごうワクチン|MMR vaccine (for measles, mumps and rubella)
凸型|とつがた|convexity
忠犬ハチ公|ちゅうけんハチこう|faithful dog Hachiko; Akita dog that waited every day at Shibuya station for the return of his owner (1923-1935)
レープクーヘン||lebkuchen; pfefferkuchen; German Christmas treat that resembles ginger bread
空飛ぶカヌー|そらとぶカヌー|canoe, etc. in very clear water (illusion of flying)
空飛ぶカヌー|そらとぶカヌー|Flying Canoe (Canadian folk-tale)
フライングダッチマン||Flying Dutchman
フライング・ダッチマン||Flying Dutchman
戦列艦|せんれつかん|ship of the line
砲列甲板|ほうれつかんぱん|gun deck (ship)
甲板いす|かんぱんいす|deck chair
甲板椅子|かんぱんいす|deck chair
シェーズロング||chaise longue; chaise lounge
シェーズ・ロング||chaise longue; chaise lounge
バーバーチェア||barber chair
バーバー・チェア||barber chair
床子|しょうじ|low bench
床子|そうじ|low bench
ニーリングチェア||kneeling chair
ニーリング・チェア||kneeling chair
ウィンドジャマー||windjammer
点滴静注|てんてきじょうちゅう|intravenous drip infusion; intravenous drip; drip infusion
サッカード||saccade (rapid unconscious eye movement)
防寒帽|ぼうかんぼう|arctic cap; watch cap
烏河豚|からす|Chinese puffer (Takifugu chinensis)
カラス||Chinese puffer (Takifugu chinensis)
瞬く|めたたく|to blink (one's eyes); to wink; to bat
瞬く|めばたく|to blink (one's eyes); to wink; to bat
目叩く|めたたく|to blink (one's eyes); to wink; to bat
瞬く|しばたたく|to blink (one's eyes); to wink; to bat
瞬く|しばたく|to blink (one's eyes); to wink; to bat
瞬く|しばだたく|to blink (one's eyes); to wink; to bat
屡叩く|しばたたく|to blink (one's eyes); to wink; to bat
屡叩く|しばだたく|to blink (one's eyes); to wink; to bat
屢叩く|しばたたく|to blink (one's eyes); to wink; to bat
屢叩く|しばだたく|to blink (one's eyes); to wink; to bat
ポートアウト||port-out; port out
ポート・アウト||port-out; port out
ポートイン||port-in; port in
ポート・イン||port-in; port in
すぼらしい||measley; paltry; deplorable; execrable
ドミノ倒し|ドミノたおし|domino toppling
橋上|きょうじょう|(on the) bridge
スピログラフ||spirograph
過労自死|かろうじし|suicide brought on by excessive overwork
過労自殺|かろうじさつ|suicide brought on by excessive overwork
ワーママ||working mother
貨幣創出|かへいそうしゅつ|money creation
小人投げ|こびとなげ|dwarf-throwing; dwarf-tossing; midget-tossing
ミオトニー||myotonia
ワンジー||onesie (jumpsuit)
仮設便所|かせつべんじょ|portable toilet
自然資本|しぜんしほん|natural capital
二重規範|にじゅうきはん|double standard
二重標準|にじゅうひょうじゅん|double standard
再生機器|さいせいきき|playback equipment; playback device
新聞学|しんぶんがく|newspaper studies; media studies
メディア研究|メディアけんきゅう|media studies
金銀複本位制|きんぎんふくほんいせい|bimetallism
証拠不十分|しょうこふじゅうぶん|lack of evidence; insufficient evidence
両本位制|りょうほんいせい|bimetallism
あるべき姿|あるべきすがた|ideal situation; ideal world; perfect world; utopia
在るべき姿|あるべきすがた|ideal situation; ideal world; perfect world; utopia
綴字法|ていじほう|spelling rules; orthography
同値類|どうちるい|equivalence class
量化|りょうか|quantification (logic)
量化子|りょうかし|quantifier
保護フィルム|ほごフィルム|protective film (e.g. for a smartphone)
刀狩|かたながり|sword hunt; sword confiscation
刀狩り|かたながり|sword hunt; sword confiscation
惣無事令|そうぶじれい|1585 edict by Toyotomi Hideyoshi which banned war between feudal lords in Japan
自力救済|じりききゅうさい|self-help
クワンザ||Kwanzaa (African-American holiday)
クワンザ||Kwanza (currency of Angola)
直道|ちょくどう|straight path (that people should take); straight road
澄徹|ちょうてつ|clearness (e.g. sky); transparency
予想に反して|よそうにはんして|contrary to one's expectations
ケロリン桶|ケロリンおけ|yellow plastic container used at public baths
公現祭|こうげんさい|Epiphany (Christian holiday)
デモ活動|デモかつどう|demonstration; protest
示威行為|しいこうい|demonstration; manifestation; protest
示威行進|じいこうしん|demonstration parade
デモ割|デモわり|discount aimed specifically at those attending a demonstration
サトゥルナリア||Saturnalia (ancient Roman festival)
サトゥルナーリア||Saturnalia (ancient Roman festival)
サートゥルナーリア||Saturnalia (ancient Roman festival)
十二夜|じゅうにや|Twelfth Night (Christian holiday)
パンケーキデイ||Shrove Tuesday; pancake day
パンケーキ・デイ||Shrove Tuesday; pancake day
大斎|たいさい|Great Lent; Great Fast
草生える|くさはえる|to laugh
代数和|だいすうわ|algebraic sum
鳥インフル|とりインフル|avian influenza; bird flu
鳥フル|とりフル|avian influenza; bird flu
難しげ|むずかしげ|difficult; hard; troublesome; complicated; serious (disease, problem, etc.)
認知バイアス|にんちバイアス|cognitive bias
アンカリング||anchoring (cognitive bias)
アンカリング||anchor ring
アンカーリング||anchoring (cognitive bias)
アンカーリング||anchor ring
根本的な帰属の誤り|こんぽんてきなきぞくのあやまり|fundamental attribution error; correspondence bias; attribution effect
証果|しょうか|enlightenment attained through training
てる||indicates continuing action or state (e.g. to be ..ing, to have been ..ing)
でる||indicates continuing action or state (e.g. to be ..ing, to have been ..ing)
てく||to continue
でく||to continue
たげる||to do for (the sake of someone else)
通貨スワップ|つうかスワップ|currency swap
窃視症|せっししょう|voyeurism; scopophilia; scoptophilia
瞠視症|どうししょう|voyeurism; scopophilia; scoptophilia
瞠視|どうし|staring at in wonder
窃視|せっし|peeping at (without permission)
グループセックス||group sex
グループ・セックス||group sex
竿姉妹|さおしまい|women who have slept with the same man
モートル||motor
腕長隠れ蛸|うでながかくれだこ|algae octopus (Abdopus aculeatus)
ウデナガカクレダコ||algae octopus (Abdopus aculeatus)
鮫肌手長蛸|さめはだてながだこ|starry night octopus (Octopus luteus)
サメハダテナガダコ||starry night octopus (Octopus luteus)
社会科見学|しゃかいかけんがく|educational visit (e.g. by a class); educational field trip
野外活動|やがいかつどう|outdoor activity
顎をしゃくる|あごをしゃくる|to jerk one's chin; to nod toward; to point one's chin at
足を向ける|あしをむける|to head towards; to direct one's steps to
ガイジ||retard; moron; cripple
剣を交える|けんをまじえる|to cross swords (with)
情報機関|じょうほうきかん|intelligence agency
情報漏洩|じょうほうろうえい|information leak; data breach
情報漏洩|じょうほうろうせつ|information leak; data breach
情報漏えい|じょうほうろうえい|information leak; data breach
コンセプトカー||concept car
コンセプト・カー||concept car
エクスクルーシブ||exclusive
身辺警護|しんぺんけいご|personal security; personal protection; provision of a bodyguard
基礎自治体|きそじちたい|municipality; basic municipality
温めムラ|あたためムラ|uneven heating of food (esp. in a microwave)
温めむら|あたためむら|uneven heating of food (esp. in a microwave)
加熱ムラ|かねつムラ|uneven heating of food (esp. in a microwave)
加熱むら|かねつむら|uneven heating of food (esp. in a microwave)
味がする|あじがする|to taste; to taste of; to have a taste
爪付きナット|つめつきナット|T-nut; blind nut
爪付ナット|つめつきナット|T-nut; blind nut
白人至上主義|はくじんしじょうしゅぎ|white supremacy; white supremacism
東部標準時|とうぶひょうじゅんじ|Eastern Standard Time; EST
中部標準時|ちゅうぶひょうじゅんじ|Central Standard Time; CST
山岳部標準時|さんがくぶひょうじゅんじ|Mountain Standard Time; MST
太平洋標準時|たいへいようひょうじゅんじ|Pacific Standard Time; PST
アラスカ標準時|アラスカひょうじゅんじ|Alaska Standard Time; AKST
ハワイアリューシャン標準時|ハワイアリューシャンひょうじゅんじ|Hawaii-Aleutian Standard Time; HAST
ハワイ・アリューシャン標準時|ハワイアリューシャンひょうじゅんじ|Hawaii-Aleutian Standard Time; HAST
ハワイ標準時|ハワイひょうじゅんじ|Hawaii-Aleutian Standard Time; HAST
西海岸標準時|にしかいがんひょうじゅんじ|Pacific Standard Time; PST
山岳標準時|さんがくひょうじゅんじ|Mountain Standard Time; MST
インドオオリス||Indian giant squirrel (Ratufa indica)
きー||screech; squeak; squeal
きーっ||screech; squeak; squeal
キー||screech; squeak; squeal
キーッ||screech; squeak; squeal
キーっ||screech; squeak; squeal
オオリス属|オオリスぞく|Ratufa (genus comprising Asiatic giant squirrels)
白人至上主義者|はくじんしじょうしゅぎしゃ|white supremacist
尿道口|にょうどうこう|urethral opening; urinary meatus
ハニトラ||honeytrap; honey trap; honeypot
許しを請う|ゆるしをこう|to beg forgiveness; to ask for someone's pardon; to ask for permission
許しを乞う|ゆるしをこう|to beg forgiveness; to ask for someone's pardon; to ask for permission
ニューリッチ||the newly rich
ニュー・リッチ||the newly rich
タワマン||high-rise apartment building; high-rise condominium; tower block
都市鉱山|としこうざん|urban mine; discarded items which can be used as a source of resources
接戦州|せっせんしゅう|swing state
激戦州|げきせんしゅう|swing state
３路スイッチ|さんろスイッチ|two-way switch (UK); three-way switch (US)
三路スイッチ|さんろスイッチ|two-way switch (UK); three-way switch (US)
４路スイッチ|よんろスイッチ|intermediate switch (UK); crossover switch (UK); four-way switch (US)
四路スイッチ|よんろスイッチ|intermediate switch (UK); crossover switch (UK); four-way switch (US)
スイングステート||swing state
スイング・ステート||swing state
Ｃスイッチ|シースイッチ|two-way switch (UK); three-way switch (US)
片切スイッチ|かたぎりスイッチ|simple on-off switch; one-way switch (UK); two-way switch (US)
持ち戻り|もちもどり|returning of a package to depot after a failed delivery attempt
持戻り|もちもどり|returning of a package to depot after a failed delivery attempt
持戻|もちもどり|returning of a package to depot after a failed delivery attempt
水晶球|すいしょうきゅう|crystal ball
二度見|にどみ|double take (esp. out of surprise)
点滴静脈注射|てんてきじょうみゃくちゅうしゃ|intravenous drip infusion; intravenous drip; drip infusion
大ファン|だいファン|big fan (of something or someone); great fan
剣奴|けんど|gladiator
揚羽擬き|あげはもどき|mock swallowtail butterfly moth (Epicopeia hainesii)
擬鳳蝶|あげはもどき|mock swallowtail butterfly moth (Epicopeia hainesii)
揚羽擬|あげはもどき|mock swallowtail butterfly moth (Epicopeia hainesii)
アゲハモドキ||mock swallowtail butterfly moth (Epicopeia hainesii)
シガーバー||cigar bar
シガー・バー||cigar bar
Ｂスイッチ|ビースイッチ|simple on-off switch; one-way switch (UK); two-way switch (US)
Ｄスイッチ|ディースイッチ|intermediate switch (UK); crossover switch (UK); four-way switch (US)
身柄を拘束する|みがらをこうそくする|to detain; to take into custody
子孫代々|しそんだいだい|generation after generation; (for) generations to come
子孫代代|しそんだいだい|generation after generation; (for) generations to come
大本|おおもと|root; source; origin; cause
Ｗｅｂスクレイピング|ウェブスクレイピング|web scraping; web harvesting
プンシュ||punsch; traditional Swedish arrack liqueur
シーザーサラダ||Caesar salad
シーザー・サラダ||Caesar salad
突出して|とっしゅつして|especially; exceptionally; remarkably; conspicuously
石こうボード|せっこうボード|gypsum board; drywall; plasterboard
石膏ボード|せっこうボード|gypsum board; drywall; plasterboard
一つの中国|ひとつのちゅうごく|One China (policy)
垂直抗力|すいちょくこうりょく|normal force
はずの無い|はずのない|cannot (do); it is impossible that...; it is (highly) unlikely that...
筈のない|はずのない|cannot (do); it is impossible that...; it is (highly) unlikely that...
筈の無い|はずのない|cannot (do); it is impossible that...; it is (highly) unlikely that...
セックスワーク||sex work
セックス・ワーク||sex work
ラップトップパソコン||laptop; laptop computer
ラップトップ・パソコン||laptop; laptop computer
やってられない||I can't go on like this
ハンセン病療養所|ハンセンびょうりょうようじょ|leper colony; leprosarium
美婦|びふ|beautiful woman; beauty
登高器|とうこうき|ascender (climbing); ascendeur; jumar
ラビゴットソース||sauce ravigote
ラヴィゴットソース||sauce ravigote
ブルータリズム||brutalism (architecture)
神回|かみかい|incredible episode (e.g. of a TV show)
卵焼き器|たまごやきき|frying pan for making rolled eggs
玉子焼き器|たまごやきき|frying pan for making rolled eggs
たまご焼き器|たまごやきき|frying pan for making rolled eggs
お化け番組|おばけばんぐみ|extremely popular long-running TV show
インフル||influenza; flu
溝貝|どぶがい|Chinese pond mussel (Sinanodonta woodiana)
土負貝|どぶがい|Chinese pond mussel (Sinanodonta woodiana)
ドブガイ||Chinese pond mussel (Sinanodonta woodiana)
でっしゃろう||right?; don't you think?; don't you agree?
ＺＩＰドライブ|ジップドライブ|Zip drive
フランジパン||frangipane
オートキュイジーヌ||haute cuisine; grande cuisine; gourmet French cuisine
オート・キュイジーヌ||haute cuisine; grande cuisine; gourmet French cuisine
ヌーベルキュイジーヌ||nouvelle cuisine
ヌーベル・キュイジーヌ||nouvelle cuisine
アミューズブーシュ||amuse-bouche; amuse-gueule
アミューズブッシュ||amuse-bouche; amuse-gueule
アミューズ・ブーシュ||amuse-bouche; amuse-gueule
アミューズ・ブッシュ||amuse-bouche; amuse-gueule
リュスティック||country-style bread
リエット||rillettes
モルネーソース||Mornay sauce
モルネー・ソース||Mornay sauce
ムールフリット||moules-frites
ムール・フリット||moules-frites
ベイクドアラスカ||baked Alaska
ベイクド・アラスカ||baked Alaska
ベアルネーズソース||Béarnaise sauce
ベアルネーズ・ソース||Béarnaise sauce
コンパンディング||companding
ピサラディエール||pissaladière
パンオショコラ||pain au chocolat
パン・オ・ショコラ||pain au chocolat
ショコラティーヌ||chocolatine; chocolate cake, esp. layered
ナヴァラン||navarin
ナバラン||navarin
タルトフランベ||tarte flambée
タルト・フランベ||tarte flambée
タプナード||tapenade
ソースグリビッシュ||sauce gribiche; gribiche sauce
ソース・グリビッシュ||sauce gribiche; gribiche sauce
ショーソンオポム||chausson aux pommes
ショーソン・オ・ポム||chausson aux pommes
シュー皮|シューかわ|cream puff shell; choux pastry
シェーブルチーズ||goat milk cheese
シェーブル・チーズ||goat milk cheese
シェーブル||goat milk cheese
シヴェ||civet; jugging
サルミ||salmis
コルドンブルー||cordon bleu; dish of veal or ham with Swiss cheese
コルドンブルー||high-class cooking
コルドンブルー||prize-winning chef
コルドン・ブルー||cordon bleu; dish of veal or ham with Swiss cheese
コルドン・ブルー||high-class cooking
コルドン・ブルー||prize-winning chef
コックオーヴァン||coq au vin
コックオバン||coq au vin
コッコーヴァン||coq au vin
コックオーバン||coq au vin
コッコーバン||coq au vin
コック・オー・ヴァン||coq au vin
コック・オ・バン||coq au vin
コック・オー・バン||coq au vin
クレームフレッシュ||crème fraîche
クレームフレーシュ||crème fraîche
クレーム・フレッシュ||crème fraîche
クレーム・フレーシュ||crème fraîche
グラニテ||granité
エルブドプロバンス||herbes de Provence (mixture of dry herbs)
エルブドプロヴァンス||herbes de Provence (mixture of dry herbs)
エルブ・ド・プロバンス||herbes de Provence (mixture of dry herbs)
エルブ・ド・プロヴァンス||herbes de Provence (mixture of dry herbs)
ヴェリーヌ||verrine
ベリーヌ||verrine
ヴェリーン||verrine
ベリーン||verrine
ヴィエノワズリー||viennoiserie
ビエノワズリー||viennoiserie
共焦点レーザー顕微鏡|きょうしょうてんレーザーけんびきょう|confocal laser microscope
共焦点|きょうしょうてん|confocal (optics)
月月火水木金金|げつげつかすいもくきんきん|seven-day workweek; working every day of the week; Mon-Mon-Tue-Wed-Thu-Fri-Fri
増加量|ぞうかりょう|increment; amount of increase
雇用流動化|こようりゅうどうか|employment mobility; fluidity of employment
高層建築物|こうそうけんちくぶつ|high-rise building; tall building; multi-storied building
ひり出す|ひりだす|to expel; to eject; to push out; to force out
放り出す|ひりだす|to expel; to eject; to push out; to force out
民譚|みんだん|folk tale; folklore
民間説話|みんかんせつわ|folk tale; folklore
周長|しゅうちょう|perimeter; circumference
空気砲|くうきほう|air cannon (toy)
共同市場|きょうどうしじょう|common market
単一市場|たんいつしじょう|single market (e.g. European single market)
劇伴|げきばん|background music (in a movie, television drama, etc.)
デイトリッパー||alpha-methyltryptamine; AMT
デイトリッパー||daytripper
ロコガール||girl from Hawaii
ロコ・ガール||girl from Hawaii
職人芸|しょくにんげい|craftsmanship; artisanship
大冠|だいかんむり|kanji "big" radical at top
四足|しそく|four legs; four-legged; quadruped
中央操作室|ちゅうおうそうさしつ|central control room; main control room
像面湾曲|ぞうめんわんきょく|curvature of field (optics)
漸層法|ぜんそうほう|climax (rhetoric); gradation
犬合わせ|いぬあわせ|dog fighting; dog fight
犬合せ|いぬあわせ|dog fighting; dog fight
書影|しょえい|outward appearance of a book; book cover
マズル||muzzle; snout
マズル||muzzle (firearm)
マズル||muzzle (device to prevent biting)
体高|たいこう|height (measured at the withers)
エイジハラスメント||age harrassment
エイジ・ハラスメント||age harrassment
エイハラ||age harassment
エクレアナマコ||éclair sea cucumber (Holothuria nigralutea)
ペテンに掛ける|ペテンにかける|to swindle; to deceive
像面|ぞうめん|image surface (optics)
不定元|ふていげん|indeterminate
大衆主義|たいしゅうしゅぎ|populism
滑り棒|すべりぼう|fireman's pole; sliding pole
滑り棒|すべりぼう|slide guide; slide bar
ポピュリスト||populist
ホームゲートウェイ||home gateway; residential gateway
ホーム・ゲートウェイ||home gateway; residential gateway
防弾ベスト|ぼうだんベスト|bulletproof vest
幼者|ようしゃ|young child; infant
碾磑|てんがい|water-powered millstone
碾磑|みずうす|water-powered millstone
水碓|みずうす|water-powered millstone
蜂巣炎|ほうそうえん|cellulitis
陶歯|とうし|porcelain tooth
激ムズ|げきムズ|extremely difficult
激むず|げきむず|extremely difficult
自殺点|じさつてん|own goal
超硬合金|ちょうこうごうきん|cemented carbide
超硬|ちょうこう|cemented carbide
超硬|ちょうこう|superhard; ultrahard
感じがする|かんじがする|to have a feeling (that); to have a sensation (that)
権利侵害|けんりしんがい|violation of rights; infringement of rights; civil wrong
市民感覚|しみんかんかく|perspective of an ordinary person; common sense; popular feeling
余儀なくさせる|よぎなくさせる|to compel; to force; to oblige
余儀無くさせる|よぎなくさせる|to compel; to force; to oblige
訴額|そがく|amount in controversy
東ドイツ|ひがしドイツ|East Germany (1949-1990); German Democratic Republic
衛星政党|えいせいせいとう|bloc party; satellite party
キックスケーター||kick scooter; push scooter
キック・スケーター||kick scooter; push scooter
キックボード||kick scooter; push scooter
キック・ボード||kick scooter; push scooter
パンリュスティック||country-style bread
パン・リュスティック||country-style bread
何とも言えない|なんともいえない|indescribable; inexpressible; unspeakable; indefinable; nobody can tell
なんとも言えない|なんともいえない|indescribable; inexpressible; unspeakable; indefinable; nobody can tell
何ともいえない|なんともいえない|indescribable; inexpressible; unspeakable; indefinable; nobody can tell
働き方|はたらきかた|work style; way of working
ユール||Yule; Christmas period
ユウル||Yule; Christmas period
双璧をなす|そうへきをなす|to be a match for; to rival; to be equal to
双璧を成す|そうへきをなす|to be a match for; to rival; to be equal to
ミーリングマシン||milling machine
ミーリング・マシン||milling machine
系列的|けいれつてき|paradigmatic; prototypical; representative
連合関係|れんごうかんけい|associative relationship; federated relationship
連合関係|れんごうかんけい|paradigmatic relation
実力以上|じつりょくいじょう|beyond oneself; beyond one's ability; exceeding one's power
エクセルギー||exergy
日英同盟|にちえいどうめい|Anglo-Japanese Alliance (1902-1923)
四大大会|よんだいたいかい|the four most important tournaments in a particular sport; grand slam tournaments; majors
４大大会|よんだいたいかい|the four most important tournaments in a particular sport; grand slam tournaments; majors
ハヌカ||Hanukkah; Chanukah; Festival of Lights
ハヌカー||Hanukkah; Chanukah; Festival of Lights
ロコ||person born in Hawaii; resident of Hawaii
グリビッシュソース||gribiche sauce; sauce gribiche
グリビッシュ・ソース||gribiche sauce; sauce gribiche
ソースアメリケーヌ||sauce américaine; American sauce
ソースアメリカン||sauce américaine; American sauce
ソース・アメリケーヌ||sauce américaine; American sauce
ソース・アメリカン||sauce américaine; American sauce
コンパンダー||compander; compandor
コンパンダ||compander; compandor
シベット||civet; civet cat
ワーキングママ||working mother
ワーキング・ママ||working mother
アミューズグール||amuse-gueule; amuse-bouche
アミューズ・グール||amuse-gueule; amuse-bouche
剣匠|けんしょう|swordsmith
姿をくらます|すがたをくらます|to disappear; to vanish; to abscond; to decamp
姿を晦ます|すがたをくらます|to disappear; to vanish; to abscond; to decamp
姿を暗ます|すがたをくらます|to disappear; to vanish; to abscond; to decamp
行方をくらます|ゆくえをくらます|to disappear; to vanish; to bolt; to go into hiding
行方を晦ます|ゆくえをくらます|to disappear; to vanish; to bolt; to go into hiding
行方を暗ます|ゆくえをくらます|to disappear; to vanish; to bolt; to go into hiding
全面協力|ぜんめんきょうりょく|full cooperation
消費者庁|しょうひしゃちょう|Consumer Affairs Agency; CAA
マタニティマーク||badge (or keyring, etc.) used to inform others that the wearer is pregnant
マタニティーマーク||badge (or keyring, etc.) used to inform others that the wearer is pregnant
マタニティ・マーク||badge (or keyring, etc.) used to inform others that the wearer is pregnant
マタニティー・マーク||badge (or keyring, etc.) used to inform others that the wearer is pregnant
方向ボタン|ほうこうボタン|directional button; button with arrow(s) (on keypad, game controller, etc.)
ジャイロセンサー||gyrosensor
ジャイロセンサ||gyrosensor
姉妹艦|しまいかん|sister ship
姉妹船|しまいせん|sister ship
キリノミタケ||Texas star (Chorioactis geaster)
蛇床子|じゃしょうし|Cnidium monnieri fruit
ジャショウシ||Cnidium monnieri fruit
七大州|ななだいしゅう|the Seven Continents
七大州|しちだいしゅう|the Seven Continents
七大洲|ななだいしゅう|the Seven Continents
七大洲|しちだいしゅう|the Seven Continents
保留音|ほりゅうおん|hold music; music on hold; hold tone
打敷|うちしき|patterned cloth laid on a table or Buddhist altar; antependium
打ち敷|うちしき|patterned cloth laid on a table or Buddhist altar; antependium
ろうそく立て|ろうそくたて|candle holder
ロウソク立て|ロウソクたて|candle holder
蝋燭立て|ろうそくたて|candle holder
蠟燭立て|ろうそくたて|candle holder
ろうそく屋|ろうそくや|chandler; candlemaker
蝋燭屋|ろうそくや|chandler; candlemaker
ロウソク屋|ロウソクや|chandler; candlemaker
蠟燭屋|ろうそくや|chandler; candlemaker
仏餉|ぶっしょう|rice offered to Buddha
仏聖|ぶっしょう|rice offered to Buddha
御仏供|おぶく|offering to Buddha (often rice)
お仏供|おぶく|offering to Buddha (often rice)
常花|とこばな|eternally flowering flower (usu. made of metal)
大床子|だいしょうじ|bench used by the Emperor
箏の琴|そうのこと|koto
大袿|おおうちき|long-sleeved kimono (Heian period)
アケゲー||arcade game
アケゲ||arcade game
マスターコントローラー||large lever used to control a train
マスター・コントローラー||large lever used to control a train
マスコン||large lever used to control a train
仏供|ぶっく|offering to the Buddha (often rice)
に依らず|によらず|in contrast to; despite
金土日|きんどにち|Friday, Saturday and Sunday
月火水|げつかすい|Monday, Tuesday and Wednesday
水木|すいもく|Wednesday and Thursday
金土|きんど|Friday and Saturday
火水木|かすいもく|Tuesday, Wednesday and Thursday
水木金|すいもくきん|Wednesday, Thursday and Friday
火水|かすい|Tuesday and Wednesday
月火水木金|げつかすいもくきん|weekday; Monday, Tuesday, Wednesday, Thursday and Friday
火水木金|かすいもくきん|Tuesday, Wednesday, Thursday and Friday
月火水木|げつかすいもく|Monday, Tuesday, Wednesday and Thursday
波食棚|はしょくだな|wave-cut platform; abrasion platform; coastal bench
波食台|はしょくだい|wave-cut platform; abrasion platform; coastal bench
ケレン味|ケレンみ|pretense; affectation; showiness
外連味|けれんみ|pretense; affectation; showiness
けれん味|けれんみ|pretense; affectation; showiness
塞翁が馬|さいおうがうま|the future is unpredictable; unscrutable are the ways of heaven; the irony of fate
愛上男|あいうえお|skilled male lover
それな||sure; certainly; that's right
りょ||understood; I understand; roger; agreed
ワンチャン||one chance; only opportunity
ワンチャン||maybe; perhaps; there is a chance that
ワンチャン||one-night stand
かまちょ||please pay attention to me; please entertain me
サビラン||eating lunch alone (esp. at the office); sad lunch
おこ||anger; being angry; being mad
しょんどい||very tiresome; exhausting; being a damn nuisance
岩屑|がんせつ|detritus (rock fragments); debris
戸籍名|こせきめい|one's official name; one's registered name; one's name as it appears on the family register
カキストクラシー||kakistocracy; government by the worst, least qualified, or most unscrupulous citizens
民主制|みんしゅせい|democracy; democratic system of government
キスフレ||kissing partner
添い寝フレンド|そいねフレンド|friends who sleep next to each other (without engaging in sexual activities)
ソフレ||friends who sleep next to each other (without engaging in sexual activities)
カモフレ||friends who pretend to be lovers; pretend lovers
泥棒を捕らえて縄を綯う|どろぼうをとらえてなわをなう|starting something in the eleventh hour; have not thy cloak to make when it begins to rain; don't lock the stable door after the horse has been stolen; braiding the rope only after the thief is caught
泥棒を捕らえて縄をなう|どろぼうをとらえてなわをなう|starting something in the eleventh hour; have not thy cloak to make when it begins to rain; don't lock the stable door after the horse has been stolen; braiding the rope only after the thief is caught
餅まき|もちまき|throwing of mochi to an assembled crowd, esp. during the framework-raising ceremony of a new building
そうだね||sure; yeah; I know
そうだよね||sure; yeah; I know
電話番|でんわばん|phone duty; being on call
核燃料デブリ|かくねんりょうデブリ|nuclear fuel debris
大統領令|だいとうりょうれい|presidential decree; executive order
有鉤条虫症|ゆうこうじょうちゅうしょう|taeniasis; cysticercosis
有機野菜|ゆうきやさい|organic vegetables; organically grown vegetables
ＬＧＢＴ|エルジービーティー|lesbian, gay, bisexual, transgender; LGBT
ＬＧＢＴ|エル・ジー・ビー・ティー|lesbian, gay, bisexual, transgender; LGBT
餅投げ|もちなげ|throwing of mochi to an assembled crowd, esp. during the framework-raising ceremony of a new building
キスフレンド||kissing friend; kissing partner
キス・フレンド||kissing friend; kissing partner
カモフラージュフレンド||friends who pretend to be lovers; pretend lovers
カモフラージュ・フレンド||friends who pretend to be lovers; pretend lovers
労基法|ろうきほう|Labor Standards Act
頬を紅潮させる|ほおをこうちょうさせる|to blush; to have flushed cheeks
ワンナイトラブ||single sexual encounter; one-night stand
ワンナイト・ラブ||single sexual encounter; one-night stand
うぇーい||hey; cheers; used by young people when drinking or as a greeting
ウェーイ||hey; cheers; used by young people when drinking or as a greeting
ウェイ系|ウェイけい|young people who behave in a rowdy fashion (e.g. in a pub); young people who cheer and drink loudly
ウェーイ系|ウェーイけい|young people who behave in a rowdy fashion (e.g. in a pub); young people who cheer and drink loudly
うぇい系|うぇいけい|young people who behave in a rowdy fashion (e.g. in a pub); young people who cheer and drink loudly
うぇーい系|うぇーいけい|young people who behave in a rowdy fashion (e.g. in a pub); young people who cheer and drink loudly
スパークリング||sparkling
全米オープン|ぜんべいオープン|US Open (esp. tennis and golf championships)
運否|うんぷ|good and bad fortune
海食棚|かいしょくだな|wave-cut platform; abrasion platform; coastal bench
ワンナイトスタンド||single-night performance (theatre, comedy, etc.); one-night stand
ワン・ナイト・スタンド||single-night performance (theatre, comedy, etc.); one-night stand
危険予知訓練|きけんよちくんれん|work injury prevention training; accident awareness training; hazard prediction training
程々に|ほどほどに|moderately; in moderation
程ほどに|ほどほどに|moderately; in moderation
程程に|ほどほどに|moderately; in moderation
愚才|ぐさい|(one's own) abilities and intelligence
非接触型決済|ひせっしょくがたけっさい|contactless payment
非接触充電|ひせっしょくじゅうでん|inductive charging; wireless charging
相互誘導|そうごゆうどう|mutual induction
相互インダクタンス|そうごインダクタンス|mutual inductance
レギオン||legion
インダクティブ充電|インダクティブじゅうでん|inductive charging
無きゃいけない|なきゃいけない|cannot do without something; indispensable; absolutely necessary
無きゃいけない|なきゃいけない|have to do
無くちゃいけない|なくちゃいけない|cannot do without something; indispensable; absolutely necessary
無くちゃいけない|なくちゃいけない|have to do
無くてはいけません|なくてはいけません|cannot do without something; indispensable; absolutely necessary
無くてはいけません|なくてはいけません|have to do
包む|くるむ|to wrap up; to tuck in; to pack; to do up; to cover with; to dress in
遺宝|いほう|historical treasures
アーミーナイフ||multipurpose knife; Swiss Army knife
非接触決済|ひせっしょくけっさい|contactless payment
無接点充電|むせってんじゅうでん|inductive charging; wireless charging
電磁誘導充電|でんじゆうどうじゅうでん|inductive charging
ワイヤレス充電|ワイヤレスじゅうでん|wireless charging
聖骨|せいこつ|saint's bones; sacred bones
聖骨箱|せいこつばこ|reliquary; feretrum
疾病構造|しっぺいこうぞう|disease pattern; disease structure
瓦窯|がよう|tile kiln
瓦窯|かわらがま|tile kiln
湿球温度|しっきゅうおんど|wet-bulb temperature
文句を言う|もんくをいう|to complain; to make a complaint
文句をいう|もんくをいう|to complain; to make a complaint
訪問介護員|ほうもんかいごいん|home-visit care worker
相人|そうにん|physiognomist
非産油国|ひさんゆこく|non-oil producing countries; non-oil nation
経血|けいけつ|menstrual blood
ジオスペース||geospace
観相家|かんそうか|physiognomist
大ボラ吹き|おおボラふき|braggart; big talker; bigmouth
大法螺吹き|おおぼらふき|braggart; big talker; bigmouth
大ぼら吹き|おおぼらふき|braggart; big talker; bigmouth
大ぼらふき|おおぼらふき|braggart; big talker; bigmouth
大ボラふき|おおボラふき|braggart; big talker; bigmouth
大法螺ふき|おおぼらふき|braggart; big talker; bigmouth
せせら笑う|せせらわらう|to laugh mockingly; to smile with contempt; to scorn
嘲笑う|せせらわらう|to laugh mockingly; to smile with contempt; to scorn
嘲ら笑う|せせらわらう|to laugh mockingly; to smile with contempt; to scorn
籠鳥恋雲|ろうちょうれんうん|longing for freedom when tied down; caged bird's longing for the open sky
紳士淑女|しんししゅくじょ|ladies and gentlemen
賢良方正|けんりょうほうせい|wise and virtuous; good and able men
米誌|べいし|American journal; American magazine
ベーシックインカム||basic income
ベーシック・インカム||basic income
経験を生かす|けいけんをいかす|to draw on one's experience; to make good use of one's experience; to turn one's experience to good account
判断材料|はんだんざいりょう|basis for decision; evidence for judging
臭い玉|においだま|tonsil stone; tonsillolith
臭い玉|くさいだま|tonsil stone; tonsillolith
匂い玉|においだま|tonsil stone; tonsillolith
匂い玉|においだま|scent ball
匂玉|においだま|tonsil stone; tonsillolith
匂玉|においだま|scent ball
臭玉|においだま|tonsil stone; tonsillolith
物質科学|ぶっしつかがく|materials science
知らぬ存ぜぬ|しらぬぞんぜぬ|complete ignorance (usu. in reference to feigning); lack of knowledge
ルビコン川を渡る|ルビコンがわをわたる|to cross the Rubicon; to pass a point of no return
指甲花|しこうか|henna
介護老人福祉施設|かいごろうじんふくししせつ|intensive-care old people's home
救貧院|きゅうひんいん|poorhouse; almshouse; workhouse
授産施設|じゅさんしせつ|vocational aid center (centre); vocational-training facility; sheltered workshop
警戒態勢|けいかいたいせい|alert status; emergency alert
語弊がある|ごへいがある|to be misleading
メインクーン||Maine coon (breed of cat)
メイン・クーン||Maine coon (breed of cat)
原文ママ|げんぶんママ|sic; sic erat scriptum; indicates that the quoted matter has been transcribed exactly as found in the source text
原文まま|げんぶんまま|sic; sic erat scriptum; indicates that the quoted matter has been transcribed exactly as found in the source text
原文儘|げんぶんまま|sic; sic erat scriptum; indicates that the quoted matter has been transcribed exactly as found in the source text
八重山青木|やえやまあおき|great morinda (Morinda citrifolia); Indian mulberry; noni; beach mulberry; cheese fruit
ヤエヤマアオキ||great morinda (Morinda citrifolia); Indian mulberry; noni; beach mulberry; cheese fruit
白丁花|はくちょうげ|snowrose (Serissa japonica); tree of a thousand stars; Japanese boxthorn
ハクチョウゲ||snowrose (Serissa japonica); tree of a thousand stars; Japanese boxthorn
オンシジューム||oncidium (Oncidium obryzatum); dancing lady orchid; golden shower orchid
オンシジウム||oncidium (Oncidium obryzatum); dancing lady orchid; golden shower orchid
乙女百合|おとめゆり|maiden lily (Lilium rubellum)
オトメユリ||maiden lily (Lilium rubellum)
地母神|じぼしん|mother goddess; earth goddess
地母神|ちぼしん|mother goddess; earth goddess
エレクトリックピアノ||electric piano
エレクトリック・ピアノ||electric piano
エレピ||electric piano
暗号通貨|あんごうつうか|cryptocurrency
クリプトカレンシー||cryptocurrency
クリプトコイン||cryptocoin; cryptocurrency
ブロックチェーン||blockchain
分散型台帳|ぶんさんがただいちょう|blockchain
法定通貨|ほうていつうか|legal tender
中央機関|ちゅうおうきかん|central organization; central authority
中央機関|ちゅうおうきかん|central government agency
採掘者|さいくつしゃ|miner
モバイル端末|モバイルたんまつ|mobile device
マイニング||mining
マイニング||data mining
マイニング||bitcoin mining
サンデードライバー||Sunday driver
サンデードライバ||Sunday driver
サンデー・ドライバー||Sunday driver
サンデー・ドライバ||Sunday driver
サンデーバンキング||providing bank services on a Sunday (esp. ATM access)
サンデー・バンキング||providing bank services on a Sunday (esp. ATM access)
サンデースクール||Sunday school
サンデー・スクール||Sunday school
っこなし||no chance of; no way that; certainly not; will never happen
オーバーテイク||overtaking (in motorsports); passing
ケルト神話|ケルトしんわ|Celtic mythology
原文のまま|げんぶんのまま|sic; sic erat scriptum; indicates that the quoted matter has been transcribed exactly as found in the source text
原文のママ|げんぶんのママ|sic; sic erat scriptum; indicates that the quoted matter has been transcribed exactly as found in the source text
原文の儘|げんぶんのまま|sic; sic erat scriptum; indicates that the quoted matter has been transcribed exactly as found in the source text
足を踏み入れる|あしをふみいれる|to set foot into; to enter; to step inside; to cross the threshold
足を踏みいれる|あしをふみいれる|to set foot into; to enter; to step inside; to cross the threshold
足をふみいれる|あしをふみいれる|to set foot into; to enter; to step inside; to cross the threshold
派手やか|はでやか|showy; flashy; flamboyant
通関ベース|つうかんベース|customs basis
水行|みずぎょう|cold-water ablutions
水行|すいぎょう|cold-water ablutions
鐘塔|しょうとう|(Western) bell tower; campanile; belfry
ちぎり取る|ちぎりとる|to tear off; to rip off
千切り取る|ちぎりとる|to tear off; to rip off
千切りとる|ちぎりとる|to tear off; to rip off
クリトリス包茎|クリトリスほうけい|clitoral phimosis
極たまに|ごくたまに|on rare occasions; once in a blue moon
極偶に|ごくたまに|on rare occasions; once in a blue moon
ごく偶に|ごくたまに|on rare occasions; once in a blue moon
オプンティア||prickly pear (Opuntia sp.)
芝居茶屋|しばいぢゃや|tearoom attached to a theater (esp. in Kabuki)
家制度|いえせいど|Japanese household legal structure (1898-1947)
茶の子|ちゃのこ|bite; collation; snack
茶の子|ちゃのこ|tea cake
茶の子|ちゃのこ|light meal taken before breakfast by peasants
喉歌|のどうた|overtone singing; throat singing
のど歌|のどうた|overtone singing; throat singing
御茶子|おちゃこ|female usher at traditional Kansai theatrical events
クリティカルヒット||critical hit (in video games)
クリティカル・ヒット||critical hit (in video games)
直通運転|ちょくつううんてん|through train; direct service
クリット||clitoris
相互乗り入れ|そうごのりいれ|mutual use of company facilities (e.g. rail tracks for through service, airport facilities, code-sharing, etc.)
石子|いしなご|pebble throwing game played by young girls
石投|いしなご|pebble throwing game played by young girls
擲石|いしなご|pebble throwing game played by young girls
本百姓|ほんひゃくしょう|freeholding farmer; freeholding peasant
名子|なご|lower class peasant; peasant working for a land-owning farmer
三等重役|さんとうじゅうやく|third-rate company director; executive in name only
小揚げ|こあげ|unloading a barge
小揚げ|こあげ|small pieces of fried tofu
小揚げ|こあげ|palanquin that carried guests to and from the red light district
小揚|こあげ|unloading a barge
小揚|こあげ|small pieces of fried tofu
小揚|こあげ|palanquin that carried guests to and from the red light district
旅の者|たびのもの|traveler; traveller; stranger
木枕|きまくら|wooden pillow
木枕|こまくら|wooden pillow
元彼女|もとかのじょ|ex-girlfriend; former girlfriend
ＵＨＴ|ユーエイチティー|ultrahigh temperature (e.g. pasteurization); UHT
ＵＨＴ|ユーエッチティー|ultrahigh temperature (e.g. pasteurization); UHT
エラ張り|エラばり|being square-jawed
えら張り|えらばり|being square-jawed
鰓張り|えらばり|being square-jawed
必要最低限|ひつようさいていげん|bare minimum; minimum necessary (amount, number, etc.)
華麗なる|かれいなる|The Great (e.g. in film and book titles); The Grand
ネオゴシック||neo-Gothic
ネオ・ゴシック||neo-Gothic
転車台|てんしゃだい|railway turntable
転車台|てんしゃだい|car turntable; driveway turntable
制御構造|せいぎょこうぞう|control flow; flow of control
投球当時|とうきゅうとうじ|time of pitch
触球|しょっきゅう|tag out; tag
ファウルフライ||foul fly
ファウル・フライ||foul fly
休日手当|きゅうじつてあて|holiday allowance; allowance for working at weekends or on a holiday
休日手当て|きゅうじつてあて|holiday allowance; allowance for working at weekends or on a holiday
なお良い|なおいい|still better; even better
尚良い|なおいい|still better; even better
尚いい|なおいい|still better; even better
石子|いしこ|pebble; small stone
毒血症|どくけつしょう|toxemia; toxaemia
特損|とくそん|extraordinary loss
お釜帽|おかまぼう|bowler hat; felt hat
御釜帽|おかまぼう|bowler hat; felt hat
特別利益|とくべつりえき|extraordinary gain
毛帽子|けぼうし|fur hat; wool hat
生理食塩水|せいりしょくえんすい|physiological saline; normal saline; saline solution
非正規化数|ひせいきかすう|subnormal number; denormal number; denormalized number
非正規数|ひせいきすう|subnormal number; denormal number; denormalized number
蝋管|ろうかん|phonograph wax cylinder; phonograph cylinder
ロウ管|ロウかん|phonograph wax cylinder; phonograph cylinder
ろう管|ろうかん|phonograph wax cylinder; phonograph cylinder
蠟管|ろうかん|phonograph wax cylinder; phonograph cylinder
脇へそれる|わきへそれる|to digress; to stray from the subject
脇へそれる|わきへそれる|to miss the target; to fly wide of the mark
脇へ逸れる|わきへそれる|to digress; to stray from the subject
脇へ逸れる|わきへそれる|to miss the target; to fly wide of the mark
高度人材|こうどじんざい|highly skilled professionals (esp. as category of immigrants); highly talented personnel
くだちゃい||please; please give me; please do for me
大叫喚地獄|だいきょうかんじごく|Mahāraurava; The Hell of Great Wailing; The Great Screaming Hell; the fifth of eight hot hells in Buddhism
賞金首|しょうきんくび|person with a bounty on their head
カリブ||Caribbean
コンセントタップ||power strip; power board
コンセント・タップ||power strip; power board
エラが張る|エラがはる|to be square-jawed
えらが張る|えらがはる|to be square-jawed
鰓が張る|えらがはる|to be square-jawed
エラ骨|エラぼね|jawbone; mandible
エラ骨|エラぼね|branchial arches (in fish); gill arches
えら骨|えらぼね|jawbone; mandible
えら骨|えらぼね|branchial arches (in fish); gill arches
鰓骨|えらぼね|jawbone; mandible
鰓骨|えらぼね|branchial arches (in fish); gill arches
鰓骨|さいこつ|jawbone; mandible
鰓骨|さいこつ|branchial arches (in fish); gill arches
集気瓶|しゅうきびん|gas collecting bottle; gas collection bottle
現代病|げんだいびょう|modern disease; disease of our time
二元性|にげんせい|duality; dualism
航空図|こうくうず|aeronautical chart
フィメール||female
フィーメール||female
フィーメイル||female
フィーメル||female
フィメイル||female
アナログレコード||analogue record; phonograph record; gramophone record
アナログ・レコード||analogue record; phonograph record; gramophone record
アナログディスク||analogue disc (e.g. LP, LaserDisc, etc.); analog disc
アナログ・ディスク||analogue disc (e.g. LP, LaserDisc, etc.); analog disc
アナログ盤|アナログばん|analog record; analogue record; phonograph record; gramophone record
ビニール盤|ビニールばん|vinyl record
でっせ||I assure you it is
繊維工場|せんいこうじょう|textile mill
顎の骨|あごのほね|jawbone; mandible
あごの骨|あごのほね|jawbone; mandible
カナディアンフットボール||Canadian football
カナディアン・フットボール||Canadian football
床面|ゆかめん|floor; floor surface
サブクエスト||subquest (in a video game); sub quest
サブクエ||subquest (in video game); sub quest
反発係数|はんぱつけいすう|coefficient of restitution
基礎学力|きそがくりょく|fundamental academic skills; expected basic knowledge (of a subject)
思わず知らず|おもわずしらず|without noticing; before one realizes; before one is aware of
思わずしらず|おもわずしらず|without noticing; before one realizes; before one is aware of
線ファスナー|せんファスナー|zip fastener; zipper
年齢確認|ねんれいかくにん|age verification
おもちゃ箱|おもちゃばこ|toy box; toy chest
玩具箱|おもちゃばこ|toy box; toy chest
翫具箱|おもちゃばこ|toy box; toy chest
アイアンサイト||iron sight (on a gun, etc.)
アイアン・サイト||iron sight (on a gun, etc.)
かと思えば|かとおもえば|no sooner than; as soon as; immediately after
かと思えば|かとおもえば|at the thought of; when I think about
アフターマーケット||aftermarket
ダッジバン||Dodge van (esp. Dodge Ram van modified for racing)
ダッジ・バン||Dodge van (esp. Dodge Ram van modified for racing)
アイスバー||ice pop; icy pole; popsicle; ice lolly
アイス・バー||ice pop; icy pole; popsicle; ice lolly
斜方晶系|しゃほうしょうけい|orthorhombic crystal system
水路橋|すいろきょう|aqueduct; water bridge
水道橋|すいどうきょう|aqueduct; water bridge
避難指示|ひなんしじ|evacuation order; evacuation notice
避難勧告|ひなんかんこく|evacuation advisory; official advice to evacuate
デジタルアナログ||digital-analog (e.g. watch, conversion)
デジタル・アナログ||digital-analog (e.g. watch, conversion)
二月病|にがつびょう|blues experienced by man who did not receive Valentine's day chocolate
マクガフィン||MacGuffin (plot device); McGuffin; maguffin
心境の変化|しんきょうのへんか|change of heart; change of mind; change in mental state
この時とばかりに|このときとばかりに|taking an unexpected opportunity
挿し込む|さしこむ|to insert; to put in; to thrust in; to plug in
挿しこむ|さしこむ|to insert; to put in; to thrust in; to plug in
挿込む|さしこむ|to insert; to put in; to thrust in; to plug in
換歯|かんし|replacement of lost teeth
咬合|こうごう|occlusion (dentistry)
ものを言わせる|ものをいわせる|to make full use of (skill, experience, authority, etc.); to take full advantage of (something); to rely on
物を言わせる|ものをいわせる|to make full use of (skill, experience, authority, etc.); to take full advantage of (something); to rely on
パルスオキシメーター||pulse oximeter
パルス・オキシメーター||pulse oximeter
オキシメーター||oximeter
人待ち|ひとまち|waiting for someone to arrive
年輪年代学|ねんりんねんだいがく|dendrochronology
多孔質|たこうしつ|porous
パスハ||pashka (Russian Easter dessert)
汚れを知らない|けがれをしらない|innocent (e.g. child); pure (e.g. heart)
抗ウイルス薬|こうウイルスやく|antiviral drug
グラウンディング||grounding
クリアリング||clearing; cleaning up
クリアリング||clearing; settling (e.g. payment)
紅紫|こうし|crimson and purple; red-purple; magenta
紅紫|べにむらさき|crimson and purple; red-purple; magenta
人文学|じんぶんがく|humanities; arts
焼け焦げる|やけこげる|to burn to a crisp; to scorch
焼けこげる|やけこげる|to burn to a crisp; to scorch
画面構成|がめんこうせい|screen layout (film, television); window layout (computer); photo layout; page layout
カラースペース||colour space; color space
カラー・スペース||colour space; color space
色域|しきいき|colour gamut; color gamut
ジエン||diene
共重合|きょうじゅうごう|copolymerization; interpolymerization
共重合体|きょうじゅうごうたい|copolymer; interpolymer
最近になって|さいきんになって|only recently; just of late
全力を尽くす|ぜんりょくをつくす|to do one's best; to put forth every effort
トイガン||toy gun
トイ・ガン||toy gun
遊戯銃|ゆうぎじゅう|toy gun
玩具銃|がんぐじゅう|toy gun
銀玉|ぎんだま|silver ball
冬祭り|ふゆまつり|winter festival
冬祭|ふゆまつり|winter festival
ベストを尽くす|ベストをつくす|to do one's best
箱買い|はこがい|buying by the box
カートン買い|カートンがい|buying by the carton (e.g. cigarettes, trading cards, etc.)
車線変更|しゃせんへんこう|lane change; changing lanes
名古屋走り|なごやばしり|Nagoya driving; bad driving for which Nagoya residents are known
電波ジャック|でんぱジャック|frequency hijacking; broadcast signal intrusion
ゲロる||to throw up; to vomit
ゲロる||to divulge; to reveal; to confess
ハイビジョンテレビ||high-definition television set; HD television set
ハイビジョン・テレビ||high-definition television set; HD television set
ガモット||colour gamut; color gamut
ガマット||colour gamut; color gamut
ギャマ||colour gamut; color gamut
建艦|けんかん|building warships; naval construction
生没|せいぼつ|birth and death; years of birth and death
生歿|せいぼつ|birth and death; years of birth and death
持ち扱う|もちあつかう|to hold or operate with one's hands; to handle
持ち扱う|もちあつかう|to find difficult to manage
持扱う|もちあつかう|to hold or operate with one's hands; to handle
持扱う|もちあつかう|to find difficult to manage
カンキツグリーニング病|カンキツグリーニングびょう|Citrus Greening Disease; Huanglongbing; CG; HLB; yellow dragon disease
柑橘|かんきつ|citrus; citrus fruit
何型|なにがた|what shape?; what type?; which model?
何型|なにがた|which blood group?
トレーディングカードゲーム||trading card game; collectible card game; customizable card game
トレーディング・カード・ゲーム||trading card game; collectible card game; customizable card game
最近どう|さいきんどう|How are you?; What's up?
ＧＫ|ジーケー|goalkeeper
ＧＫ|ジーケー|goal kick
ＧＫ|ジーケー|joint party (e.g. by students from several colleges)
ＰＫ|ピーケー|penalty kick
ＰＫ|ピーケー|psychokinesis
ＰＫ|ピーケー|parkour
代数的数|だいすうてきすう|algebraic number
秋田蕗|あきたぶき|Japanese butterbur (Petasites japonicus subsp. giganteus)
アキタブキ||Japanese butterbur (Petasites japonicus subsp. giganteus)
精神的ショック|せいしんてきショック|acute stress reaction; acute stress disorder; psychological shock; mental shock; emotional shock; emotional trauma
急性ストレス障害|きゅうせいストレスしょうがい|acute stress disorder; ASD
外傷体験|がいしょうたいけん|traumatic experience
十分統計量|じゅうぶんとうけいりょう|sufficient statistic
パン一|パンいち|(wearing only) a pair of underpants
パンイチ||(wearing only) a pair of underpants
実務実習|じつむじっしゅう|clinical teaching; clinical training
ＶＸ|ブイエックス|VX (nerve gas)
プレミアムフライデー||last Friday of the month; government-backed campaign to allow workers to go home early the last Friday of the month
プレミアム・フライデー||last Friday of the month; government-backed campaign to allow workers to go home early the last Friday of the month
スイスロール||Swiss roll
缶バッジ|かんバッジ|tin badge; button badge; button pin
缶バッチ|かんバッチ|tin badge; button badge; button pin
ピンズ||lapel pin; pin badge
ピンバッジ||lapel pin; pin badge
ピンバッチ||lapel pin; pin badge
ピン・バッジ||lapel pin; pin badge
ピン・バッチ||lapel pin; pin badge
ブライダルインナー||bridal underwear
ブライダル・インナー||bridal underwear
降格圏|こうかくけん|relegation zone
０型|ゼロがた|type 0 blood; blood group 0
安保闘争|あんぽとうそう|campaign against the Japan-U.S. Security Treaty (1959-60, 1970)
骨肉相食む|こつにくあいはむ|to have a consanguineous feud; to fight between family members; to have an internecine feud
世紀末的|せいきまつてき|fin-de-siècle; decadent
底抜け上戸|そこぬけじょうご|extremely heavy drinker; insatiable drinker
現金取引|げんきんとりひき|cash transaction
現物取引|げんぶつとりひき|spot transaction
関係代数|かんけいだいすう|relation algebra
関係代数|かんけいだいすう|relational algebra
付随的|ふずいてき|ancillary; incidental; accompanying
破折|はせつ|fracture (of tooth)
走行中|そうこうちゅう|while running; while moving; in motion
常微分方程式|じょうびぶんほうていしき|ordinary differential equation
法体系|ほうたいけい|legal structure; legal system; jurisprudence
会社帰り|かいしゃがえり|on the way home from work; returning from work
確率微分方程式|かくりつびぶんほうていしき|stochastic differential equation
非線形微分方程式|ひせんけいびぶんほうていしき|nonlinear differential equation
非線型微分方程式|ひせんけいびぶんほうていしき|nonlinear differential equation
対合|たいごう|pairing; pairwise association
対合|たいごう|synapsis
対合|たいごう|involution
対合|ついごう|pairing; pairwise association
対合|ついごう|synapsis
対合|ついごう|involution
非線形光学|ひせんけいこうがく|nonlinear optics
非線型光学|ひせんけいこうがく|nonlinear optics
非線形性|ひせんけいせい|nonlinearity
非線型性|ひせんけいせい|nonlinearity
掛取引|かけとりひき|sales on credit; dealings on credit; on account
掛け取引|かけとりひき|sales on credit; dealings on credit; on account
カーステ||car stereo
無人ロボット|むじんロボット|unmanned robot
パサータ||passata
俺が俺が|おれがおれが|me, me, me; strong ego
思考実験|しこうじっけん|thought experiment; gedankenexperiment
潜伏先|せんぷくさき|hideout (e.g. of fugitive from justice); hiding place
ボーダーコリー||border collie
ボーダー・コリー||border collie
二重盲検試験|にじゅうもうけんしけん|double blind test; double blind trial
利用規約|りようきやく|terms of service; terms of use; terms and conditions
滲みやすい|にじみやすい|easily flowing (ink, make-up, etc.); easy spreading
滲み易い|にじみやすい|easily flowing (ink, make-up, etc.); easy spreading
針を含む|はりをふくむ|to hurt someone's feelings
バカ安|バカやす|bargain price
馬鹿安|ばかやす|bargain price
ばか安|ばかやす|bargain price
派手派手しい|はではでしい|flashy; gaudy; flamboyant
奇襲をかける|きしゅうをかける|to launch a surprise attack
奇襲を掛ける|きしゅうをかける|to launch a surprise attack
スピンオフドラマ||spin-off drama
スピンオフ・ドラマ||spin-off drama
奇襲作戦|きしゅうさくせん|surprise tactics
地政学的|ちせいがくてき|geopolitical; geostrategic
無菌性|むきんせい|aseptic; sterile; abacterial
超微細|ちょうびさい|hyperfine; ultrafine; nanoscale; nano-; micro-
慣習的|かんしゅうてき|customary; conventional; traditional; usual
古本市|ふるほんいち|secondhand book fair; antiquarian book market
多重継承|たじゅうけいしょう|multiple inheritance
論理値|ろんりち|logical value (true or false); truth value
長整数|ちょうせいすう|long integer
短整数|たんせいすう|short integer
対話モード|たいわモード|interactive mode
バイト列|バイトれつ|byte string; byte sequence; sequence of bytes
内包表記|ないほうひょうき|list comprehension
山括弧|やまかっこ|angle bracket (e.g. <>); chevron
隅付き括弧|すみつきかっこ|lenticular bracket
波括弧|なみかっこ|curly bracket
原則禁煙|げんそくきんえん|smoking-free principle; no-smoking rule; smoking ban; ban on smoking
鑑定価格|かんていかかく|appraised value; appraisal; valuation
環境構築|かんきょうこうちく|setting up an environment; creation of an environment
自己完結的|じこかんけつてき|self-absorbed; self-contained
集積度|しゅうせきど|degree of integration (e.g. components per chip)
履き古す|はきふるす|to wear out; to wear until threadbare
創発的|そうはつてき|emerging; emergent
創作物|そうさくぶつ|creative work (e.g. artistic, literary)
凶運|きょううん|doom; fate; misfortune; disaster
写真測量法|しゃしんそくりょうほう|photogrammetry
投げナイフ|なげナイフ|throwing knife
プラ段|プラだん|corrugated plastic; corriboard; corflute
プラダン||corrugated plastic; corriboard; corflute
段プラ|だんプラ|corrugated plastic; corriboard; corflute
ダンプラ||corrugated plastic; corriboard; corflute
プラスチック段ボール|プラスチックだんボール|corrugated plastic; corriboard; corflute
プラスチックダンボール||corrugated plastic; corriboard; corflute
不斉地|ふせいち|uneven ground; broken terrain
ダブルダッチ||double Dutch (jump rope)
ダブル・ダッチ||double Dutch (jump rope)
動物考古学|どうぶつこうこがく|archaeozoology; archeozoology; zooarchaeology
点検口|てんけんこう|access hole (usu. floor or ceiling trap); inspection hole
食器洗浄機|しょっきせんじょうき|dishwasher; dishwashing machine
食器洗浄機|しょっきせんじょうき|industrial dishwasher
食器洗浄器|しょっきせんじょうき|dishwasher; dishwashing machine
食器洗浄器|しょっきせんじょうき|industrial dishwasher
ランパン||running shorts; running pants
笑かす|わらかす|to make laugh; to set to laughing
旧皇族|きゅうこうぞく|Old Imperial Family; former Imperial family; eleven former houses of the Imperial Family stripped of membership in 1947
ランニングパンツ||running shorts; running pants
ランニング・パンツ||running shorts; running pants
笑わせる|わらわせる|to make laugh; to set to laughing
笑わかす|わらわかす|to make laugh; to set to laughing
陸塊|りくかい|landmass
大陸塊|たいりくかい|continental block; continental landmass; craton
電撃戦|でんげきせん|blitzkrieg; lightning war
竹馬に乗る|たけうまにのる|to walk on stilts
付加刑|ふかけい|supplementary punishment
附加刑|ふかけい|supplementary punishment
引き回し|ひきまわし|taking someone around
引き回し|ひきまわし|guidance
引き回し|ひきまわし|parading a criminal through town before their execution (Edo period)
引き廻し|ひきまわし|taking someone around
引き廻し|ひきまわし|guidance
引き廻し|ひきまわし|parading a criminal through town before their execution (Edo period)
引廻し|ひきまわし|taking someone around
引廻し|ひきまわし|guidance
引廻し|ひきまわし|parading a criminal through town before their execution (Edo period)
引回し|ひきまわし|taking someone around
引回し|ひきまわし|guidance
引回し|ひきまわし|parading a criminal through town before their execution (Edo period)
お前ら|おまえら|you (plural)
お前等|おまえら|you (plural)
おまえ等|おまえら|you (plural)
御前等|おまえら|you (plural)
御前ら|おまえら|you (plural)
ばばっちい||dirty; unclean
昼メロ|ひるメロ|soap opera
昼帯|ひるおび|soap opera
捨て札|すてふだ|bulletin board displaying the name, age, offence, etc. of a criminal sentenced to death (Edo period)
捨札|すてふだ|bulletin board displaying the name, age, offence, etc. of a criminal sentenced to death (Edo period)
昼ドラマ|ひるドラマ|daytime television serial; soap opera
潰える|ついえる|to fall apart; to collapse; to become useless
潰える|ついえる|to be completely defeated (in battle); to be wiped out
潰える|ついえる|to fall apart (one's body or health)
弊える|ついえる|to fall apart; to collapse; to become useless
弊える|ついえる|to be completely defeated (in battle); to be wiped out
弊える|ついえる|to fall apart (one's body or health)
新社会資本|しんしゃかいしほん|new social infrastructure
地域振興|ちいきしんこう|promotion of regional development; encouragement of local development
真剣白刃取り|しんけんしらはどり|stopping a sword stroke between one's bare hands
コーン茶|コーンちゃ|corn tea
身を案じる|みをあんじる|to be worried about; to be concerned for someone's welfare
古形|こけい|old form; old format; traditional format
ダム穴|ダムあな|bell-mouth spillway; morning glory spillway; glory hole spillway
クロッチ||crotch (of clothing)
くろっち||crotch (of clothing)
安保理事会|あんぽりじかい|UN Security Council
撒き水|まきみず|sprinkling water (on the ground); sprinkled water
酣戦|かんせん|height of battle
悄愴|しょうそう|sad and lamenting
悄愴|しょうそう|lonely
奸邪|かんじゃ|wicked person; evil thing
姦邪|かんじゃ|wicked person; evil thing
敗余|はいよ|after a losing battle; being defeated
豪猛|ごうもう|strongly ferocious
剛猛|ごうもう|strongly ferocious
幻人|げんじん|witchcraft user; magician
眩人|げんじん|witchcraft user; magician
日々是好日|にちにちこれこうじつ|every day is a good day
日々是好日|にちにちこれこうにち|every day is a good day
日々是好日|ひびこれこうじつ|every day is a good day
日々是好日|ひびこれこうにち|every day is a good day
日日是好日|にちにちこれこうじつ|every day is a good day
日日是好日|にちにちこれこうにち|every day is a good day
日日是好日|ひびこれこうじつ|every day is a good day
日日是好日|ひびこれこうにち|every day is a good day
教養のない|きょうようのない|crude; philistine; uncultivated; uneducated; vulgar
挺幹|ていかん|caudex (of a plant)
反応兵器|はんのうへいき|extremely powerful weapon (e.g. nuclear); reaction weapon
カーテシー||curtsy; curtsey
等間隔|とうかんかく|at regular intervals; evenly spaced
ルアウ||luau; traditional Hawaiian party
グースネックマイク||gooseneck microphone
グースネック・マイク||gooseneck microphone
コーデ||coordination; matching (e.g. clothes, accessories, furniture, colours)
スーパー楕円|スーパーだえん|superellipse
無限定|むげんてい|all-encompassing; unqualified (e.g. opinion)
法治主義|ほうちしゅぎ|constitutionalism; rule of law; legalism
完全武装|かんぜんぶそう|fully armed; armed to the teeth
お抱え|おかかえ|personal (employee); employed; retained
御抱え|おかかえ|personal (employee); employed; retained
健闘を祈る|けんとうをいのる|to wish someone good luck; to wish someone success
圧状|おうじょう|document written under duress
圧状|おうじょう|coercion
往生|おうじょう|coercion
謀書|ぼうしょ|forgery of documents; forged document
英学|えいがく|study of the English language as a means to acquire Western knowledge (esp. after the end of Japan's period of isolation)
英学|えいがく|English literature; British studies
老い先短い|おいさきみじかい|not having long to live
ハンドドライヤー||hand dryer
ハンドドライヤー||hand-held hair dryer
ハンド・ドライヤー||hand dryer
ハンド・ドライヤー||hand-held hair dryer
殺菌灯|さっきんとう|germicidal lamp
四足歩行|しそくほこう|quadruped walking; walking on four legs
アイルランドの首相|アイルランドのしゅしょう|taoiseach; prime minister of Ireland
線形代数学|せんけいだいすうがく|linear algebra
線型代数学|せんけいだいすうがく|linear algebra
競り負ける|せりまける|to lose a closely fought contest
せり負ける|せりまける|to lose a closely fought contest
拙攻|せっこう|poor offense; poor attacking play
中心力|ちゅうしんりょく|central force
タオルペーパー||paper towels (for drying one's hands)
タオル・ペーパー||paper towels (for drying one's hands)
歯を立てる|はをたてる|to bite; to sink one's teeth into; to nip
動植物園|どうしょくぶつえん|zoo and botanical garden
憎っくき|にっくき|accursed; damned; blasted
生薬学|しょうやくがく|pharmacognosy; the study of medicinal drugs derived from plants or other natural sources
創薬|そうやく|drug discovery; drug design; development of new drugs
ふくろう座|ふくろうざ|Noctua (no longer recognized constellation); the Owl
梟座|ふくろうざ|Noctua (no longer recognized constellation); the Owl
育薬|いくやく|observing and reviewing the effects of a drug after it has been released onto the market
果樹園芸学|かじゅえんげいがく|pomology; fruit crop science
中毒学|ちゅうどくがく|toxicology
ティザーヌ||herbal tea; herb tea; tisane
済美|せいび|achieving virtue
閉脚|へいきゃく|closing the legs; keeping the legs together (in gymnastics)
スキーブーツ||ski boots
スキー・ブーツ||ski boots
困難を極める|こんなんをきわめる|to be extremely difficult; to present a major challenge
困難をきわめる|こんなんをきわめる|to be extremely difficult; to present a major challenge
痛単車|いたんしゃ|motorcycle decorated with anime characters
ラッピング車両|ラッピングしゃりょう|decorated railroad car
痛バイク|いたバイク|motorcycle decorated with anime characters
痛電車|いたでんしゃ|train decorated with anime characters
ラッピングフィルム||wrapping film
ラッピングフィルム||lapping film
ラッピング・フィルム||wrapping film
ラッピング・フィルム||lapping film
萌車|もえしゃ|car decorated with (female) anime characters
痛タク|いたタク|taxi decorated with anime characters
広告宣伝車|こうこくせんでんしゃ|billboard truck; advertising truck
アドトラック||advertising truck
スポーツコンパクト||sport compact (car)
スポーツ・コンパクト||sport compact (car)
ホットハッチ||hot hatch (car)
ホット・ハッチ||hot hatch (car)
ノーズアート||nose art (aircraft)
ノーズ・アート||nose art (aircraft)
痛ネイル|いたネイル|nails adorned with images of anime characters
公の秩序|おおやけのちつじょ|public order; public policy
善良の風俗|ぜんりょうのふうぞく|good morals; public order
ヒートン||screw eye; eye bolt
オリパラ||Olympics and Paralympics
痛バッグ|いたバッグ|handbag decorated with anime characters (esp. with badges)
痛バ|いたバ|handbag decorated with anime characters (esp. with badges)
お薬手帳|おくすりてちょう|drug history handbook; drug notebook; medical diary
おくすり手帳|おくすりてちょう|drug history handbook; drug notebook; medical diary
門前薬局|もんぜんやっきょく|pharmacy right outside a doctor's office or hospital
導入教育|どうにゅうきょういく|introductory education; orientation education (e.g. for new employees)
会遇|かいぐう|meeting; happening across
フリースペース||free space; freely-usable space
フリー・スペース||free space; freely-usable space
落葉広葉樹林|らくようこうようじゅりん|deciduous broad-leaved forest
地域薬局|ちいきやっきょく|community pharmacy
厳めしい|いかめしい|stern; austere; grave; dignified; formidable; solemn; majestic
厳めしい|いかめしい|severe; strict; rigid; unsparing; relentless
鎖付図書|くさりつきとしょ|chained library; library where the books are attached to their bookcase with a chain
鎖付き図書|くさりつきとしょ|chained library; library where the books are attached to their bookcase with a chain
ピンク色|ピンクいろ|pink
言葉を返す|ことばをかえす|to reply; to respond; to answer
国立研究開発法人|こくりつけんきゅうかいはつほうじん|national research and development agency
丸走|まるそう|biker gang (police slang)
マル走|マルそう|biker gang (police slang)
ゼロヨン||quarter-mile drag race
エアロパーツ||aerodynamic automobile parts; body kit; bodykit
チューニングカー||tuned car; modified car
チューンドカー||tuned car; modified car
旧車|きゅうしゃ|antique car or motorcycle
ヒストリックカー||classic car
ヒストリック・カー||classic car
旧車会|きゅうしゃかい|classic car club; antique car club
旧車會|きゅうしゃかい|biker club using classic motorbikes
徒歩暴走族|とほぼうそうぞく|pseudo-bike gang which travels on foot
ジオキャッシング||geocaching
小ロシア|しょうロシア|Little Russia; Ukraine
アドアラー||adorer
吸着原子|きゅうちゃくげんし|adatom; adsorbed atom
アドアトム||adatom; adsorbed atom
スキットル||hip flask
味噌おでん|みそおでん|oden made with haccho miso
味噌御田|みそおでん|oden made with haccho miso
胸キュン|むねキュン|heart pounding; chest tightening
胸きゅん|むねきゅん|heart pounding; chest tightening
十柱戯|じっちゅうぎ|tenpin bowling
ボウリングレーン||bowling lane
ボウリング・レーン||bowling lane
抽挿|ちゅうそう|in and out movement (esp. during intercourse); pistoning
電話リクエスト|でんわリクエスト|phone in request (e.g. calling a radio station to request a song)
電リク|でんリク|phone in request (e.g. calling a radio station to request a song)
逆電|ぎゃくでん|(TV or radio host) calling a listener
逆電圧|ぎゃくでんあつ|reverse voltage
金閣|きんかく|golden pavilion
ギロピタ||gyros; doner kebab
ギロス||gyros; doner kebab
ビタミンＢ|ビタミンビー|vitamin B; B vitamins
乳暈|にゅううん|areola mammae (circular area around nipple); areola
クランベリー豆|クランベリーまめ|borlotti bean; cranberry bean
カラバル豆|カラバルまめ|calabar bean; ordeal bean
赤いんげん豆|あかいんげんまめ|red kidney bean
赤インゲン豆|あかインゲンまめ|red kidney bean
赤隠元豆|あかいんげんまめ|red kidney bean
バタービーンズ||butter beans; lima beans
バター・ビーンズ||butter beans; lima beans
白いんげん豆|しろいんげんまめ|cannellini bean; white kidney bean; navy bean; haricot bean; great northern bean
白インゲン豆|しろインゲンまめ|cannellini bean; white kidney bean; navy bean; haricot bean; great northern bean
白隠元豆|しろいんげんまめ|cannellini bean; white kidney bean; navy bean; haricot bean; great northern bean
白インゲンマメ|しろインゲンマメ|cannellini bean; white kidney bean; navy bean; haricot bean; great northern bean
シロインゲンマメ||cannellini bean; white kidney bean; navy bean; haricot bean; great northern bean
カネリーニ豆|カネリーニまめ|cannellini bean; white kidney bean; navy bean
花大根|はなだいこん|sweet rocket (Hesperis matronalis); dame's rocket; dame's violet; damask violet
花大根|はなだいこん|Chinese violet cress (Orychophragmus violaceus)
ハナダイコン||sweet rocket (Hesperis matronalis); dame's rocket; dame's violet; damask violet
ハナダイコン||Chinese violet cress (Orychophragmus violaceus)
紫花菜|むらさきはなな|Chinese violet cress (Orychophragmus violaceus)
ムラサキハナナ||Chinese violet cress (Orychophragmus violaceus)
紫花豆|むらさきはなまめ|scarlet runner bean
ムラサキハナマメ||scarlet runner bean
黒目豆|くろめまめ|black-eyed pea; black-eyed bean
クロメマメ||black-eyed pea; black-eyed bean
黒大豆|くろだいず|black soybean
クロダイズ||black soybean
クロルピリホス||chlorpyrifos
焼け跡世代|やけあとせだい|generation comprising those who were children during WW2 (in Japan)
墨付け正月|すみつけしょうがつ|event where young men and women paint each others' cheeks with black ink or soot during Little New Year in the San'in region
小吃|シャオチー|xiaochi; Chinese street food consumed as a light meal or snack
湯円|タンエン|tangyuan; tang yuan; Chinese dumplings made from glutinous rice flour
湯円|タンユエン|tangyuan; tang yuan; Chinese dumplings made from glutinous rice flour
湯円|タンユェン|tangyuan; tang yuan; Chinese dumplings made from glutinous rice flour
湯圓|タンエン|tangyuan; tang yuan; Chinese dumplings made from glutinous rice flour
湯圓|タンユエン|tangyuan; tang yuan; Chinese dumplings made from glutinous rice flour
湯圓|タンユェン|tangyuan; tang yuan; Chinese dumplings made from glutinous rice flour
呉語|ごご|Wu Chinese (language)
炒り米|いりごめ|parched rice; roasted rice
煎り米|いりごめ|parched rice; roasted rice
炒米|いりごめ|parched rice; roasted rice
煎米|いりごめ|parched rice; roasted rice
炒り湯|いりゆ|roasted rice broth; roasted rice broth soup
煎り湯|いりゆ|roasted rice broth; roasted rice broth soup
炒湯|いりゆ|roasted rice broth; roasted rice broth soup
煎湯|いりゆ|roasted rice broth; roasted rice broth soup
みゆき族|みゆきぞく|young men and women who frequented Miyuki Street, Ginza, in the summer of 1964
バミューダパンツ||Bermuda shorts
バーミューダパンツ||Bermuda shorts
バミューダ・パンツ||Bermuda shorts
バーミューダ・パンツ||Bermuda shorts
かに族|かにぞく|backpacker (esp. mid-60s to end-70s)
カニ族|カニぞく|backpacker (esp. mid-60s to end-70s)
バッパー||hostel
バッパー||backpacker
侵出|しんしゅつ|intrusion
一般産業|いっぱんさんぎょう|general industry
他社株転換社債|たしゃかぶてんかんしゃさい|exchangeable bond
他社株転換債|たしゃかぶてんかんさい|exchangeable bond
ＥＢ|イービー|electronic book; e-book
ＥＢ|イービー|electronic banking
ＥＢ|イービー|electron beam
ＥＢ|イービー|exchangeable bond
デジタル書籍|デジタルしょせき|digital book; electronic book; e-book
携帯電話会社|けいたいでんわがいしゃ|mobile phone operator; mobile network carrier; cellular company
業務支援|ぎょうむしえん|business support
厳にする|げんにする|to strengthen; to fortify; to secure
移動体通信事業者|いどうたいつうしんじぎょうしゃ|mobile network operator; MNO; wireless service provider; mobile network carrier
電気通信事業者|でんきつうしんじぎょうしゃ|telecommunications carrier; telecommunications operator; telephone service provider
大紫羅欄花|おおあらせいとう|Chinese violet cress (Orychophragmus violaceus)
オオアラセイトウ||Chinese violet cress (Orychophragmus violaceus)
言い損ない|いいそこない|slip of the tongue; verbal mistake; using the wrong words; misstatement; gaffe
言いそこない|いいそこない|slip of the tongue; verbal mistake; using the wrong words; misstatement; gaffe
言損ない|いいそこない|slip of the tongue; verbal mistake; using the wrong words; misstatement; gaffe
伏し浮き|ふしうき|prone float; dead-man's float
ふし浮き|ふしうき|prone float; dead-man's float
指差喚呼|しさかんこ|pointing and calling (occupational safety method)
指差喚呼|ゆびさしかんこ|pointing and calling (occupational safety method)
指差し喚呼|ゆびさしかんこ|pointing and calling (occupational safety method)
蔓脚類|まんきゃくるい|Cirripedia; barnacles
蔓脚類|つるあしるい|Cirripedia; barnacles
蔦葉貝|つたのはがい|Penepatella stellaeformis (species of limpet)
蔦の葉貝|つたのはがい|Penepatella stellaeformis (species of limpet)
ツタノハガイ||Penepatella stellaeformis (species of limpet)
点を稼ぐ|てんをかせぐ|to score points with (a person); to curry favor with (favour)
点をかせぐ|てんをかせぐ|to score points with (a person); to curry favor with (favour)
零余子虎の尾|むかごとらのお|alpine bistort (Bistorta vivipara)
ムカゴトラノオ||alpine bistort (Bistorta vivipara)
玉蕗|たまぶき|Parasenecio farfarifolius var. bulbifer (variety of Indian plantain)
球蕗|たまぶき|Parasenecio farfarifolius var. bulbifer (variety of Indian plantain)
タマブキ||Parasenecio farfarifolius var. bulbifer (variety of Indian plantain)
背にする|せにする|to turn one's back to
城将|じょうしょう|commander of a castle
山母子|やまははこ|western pearly everlasting (Anaphalis margaritacea); pearly everlasting
ヤマハハコ||western pearly everlasting (Anaphalis margaritacea); pearly everlasting
トンネルボーリングマシン||tunnel boring machine; TBM
トンネル・ボーリング・マシン||tunnel boring machine; TBM
トンネル掘削機|トンネルくっさくき|tunnel boring machine; TBM
肩紐|かたひも|shoulder strap (on a dress)
肩ひも|かたひも|shoulder strap (on a dress)
製パン|せいパン|bread making
ランウェイショー||fashion show (on a catwalk)
ランウエイショー||fashion show (on a catwalk)
ランウェイ・ショー||fashion show (on a catwalk)
ランウエイ・ショー||fashion show (on a catwalk)
沐する|もくする|to wash one's hair or body; to bathe in water
沐する|もくする|to receive (a favor, blessing, benefit)
肉粉|にくふん|meat meal; meat scrap
根掛かり|ねがかり|catching a fishing hook on seaweed, coral, etc. on the seabed or riverbed
根がかり|ねがかり|catching a fishing hook on seaweed, coral, etc. on the seabed or riverbed
根掛り|ねがかり|catching a fishing hook on seaweed, coral, etc. on the seabed or riverbed
トディ||toddy (drink)
トディー||toddy (drink)
トデー||toddy (drink)
裁縫鳥|さいほうちょう|tailorbird (Orthotomus sp.)
サイホウチョウ||tailorbird (Orthotomus sp.)
寝取られ|ねとられ|cuckolding
ヘタイラ||hetaira (ancient Greek prostitute)
ヘタエラ||hetaira (ancient Greek prostitute)
初夜権|しょやけん|right of first night; jus primae noctis; droit du seigneur
色情症|しきじょうしょう|hypersexuality
色情症|しきじょうしょう|erotomania
ホームグロウンテロ||homegrown terrorism; domestic terrorism
ホームグロウン・テロ||homegrown terrorism; domestic terrorism
歴史地理学|れきしちりがく|historical geography
商業地理学|しょうぎょうちりがく|commercial geography
人文地理学|じんぶんちりがく|human geography
人文地理学|じんもんちりがく|human geography
軍事地理学|ぐんじちりがく|military geography
息を切る|いきをきる|to gasp for air; to pant; to be out of breath
息をきる|いきをきる|to gasp for air; to pant; to be out of breath
撫でさする|なでさする|to caress; to stroke
撫で摩る|なでさする|to caress; to stroke
ひまわり油|ひまわりゆ|sunflower oil
ひまわり油|ひまわりあぶら|sunflower oil
ヒマワリ油|ヒマワリゆ|sunflower oil
ヒマワリ油|ヒマワリあぶら|sunflower oil
向日葵油|ひまわりゆ|sunflower oil
向日葵油|ひまわりあぶら|sunflower oil
親鉄元素|しんてつげんそ|siderophile element
親銅元素|しんどうげんそ|chalcophile element
親石元素|しんせきげんそ|lithophile element
親気元素|しんきげんそ|atmophile element
けろけろ||completely; entirely
けろけろ||nonchalantly; as if nothing happened
他害|たがい|harming others
キャノーラ油|キャノーラゆ|canola oil; rapeseed oil
キャノーラ油|キャノーラあぶら|canola oil; rapeseed oil
聞きよう|ききよう|way of hearing; way a spoken statement is taken; way of asking
聞き様|ききよう|way of hearing; way a spoken statement is taken; way of asking
聞様|ききよう|way of hearing; way a spoken statement is taken; way of asking
市場原理主義|しじょうげんりしゅぎ|market fundamentalism
こね鉢|こねばち|kneading trough; kneading bowl
捏ね鉢|こねばち|kneading trough; kneading bowl
ぴょん||with a nimble jump; light-footed
水切り台|みずきりだい|drainboard; draining board
水きり台|みずきりだい|drainboard; draining board
衣装部屋|いしょうべや|walk-in closet; wardrobe room; dressing room; costume room
精密工学|せいみつこうがく|precision engineering
御典医|ごてんい|doctor to a shogun or daimyo (Edo period)
御殿医|ごてんい|doctor to a shogun or daimyo (Edo period)
物置部屋|ものおきべや|storage room; store room; lumber room
古典古代|こてんこだい|classical antiquity
３９|さんきゅう|thank you
忌み数|いみかず|unlucky number
忌数|いみかず|unlucky number
一揃|ピンぞろ|snake eyes (dice); double ones
ピンゾロ||snake eyes (dice); double ones
焼夷|しょうい|burning (something) away; burning (something) down
テレプロンプター||teleprompter; autocue
リフ||riff
手球|てだま|cue ball
直ぐと|すぐと|immediately; at once; right away
直ぐと|すぐと|directly; in person; first hand
閉鎖血管系|へいさけっかんけい|closed blood-vascular system
血管系|けっかんけい|blood circulatory system; vascular system
魔の手|まのて|evil influence; (evil) clutches; tentacles of evil
歌歌い|うたうたい|singer; vocalist
歌歌い|うたうたい|nagauta singer (in kabuki)
歌歌い|うたうたい|singer of Noh chants
歌唄い|うたうたい|singer; vocalist
歌唄い|うたうたい|nagauta singer (in kabuki)
歌唄い|うたうたい|singer of Noh chants
歌謡い|うたうたい|singer; vocalist
歌謡い|うたうたい|nagauta singer (in kabuki)
歌謡い|うたうたい|singer of Noh chants
歌うたい|うたうたい|singer; vocalist
歌うたい|うたうたい|nagauta singer (in kabuki)
歌うたい|うたうたい|singer of Noh chants
即完売|そくかんばい|selling out immediately
牛すね|ぎゅうすね|beef shin; beef shank; gravy beef
牛スネ|ぎゅうスネ|beef shin; beef shank; gravy beef
牛脛|ぎゅうすね|beef shin; beef shank; gravy beef
無限定適正意見|むげんていてきせいいけん|unqualified opinion
大陸間弾道弾|たいりくかんだんどうだん|intercontinental ballistic missile; ICBM
生配信|なまはいしん|live (internet) broadcast; live stream
ジェマイユ||gemmail; type of stained glass art
カフェインレス||decaffeinated; caffeine-free; uncaffeinated; non-caffeinated
耐力壁|たいりょくへき|load-bearing wall; bearing wall
耐力壁|たいりょくかべ|load-bearing wall; bearing wall
チャイニーズタイペイ||Chinese Taipei; name used by the Republic of China (Taiwan) when participating in international competitions
チャイニーズ・タイペイ||Chinese Taipei; name used by the Republic of China (Taiwan) when participating in international competitions
ダブステップ||dubstep
デカフェ||decaf; decaffeinated coffee; decaffeinated
ディカフェ||decaf; decaffeinated coffee; decaffeinated
ディカフ||decaf; decaffeinated coffee; decaffeinated
ディキャフ||decaf; decaffeinated coffee; decaffeinated
建軍|けんぐん|founding of an army (navy, air force)
右左折|うさせつ|right and left turning (esp. in a motor vehicle)
泣くに泣けない|なくになけない|extremely disappointing; extremely frustrating; mortifying; vexing
青天白日旗|せいてんはくじつき|Blue Sky with a White Sun; party flag and emblem of the Kuomintang (Chinese Nationalist Party)
青天白日満地紅旗|せいてんはくじつまんちこうき|Blue Sky, White Sun, and a Wholly Red Earth; flag of the Republic of China
星間空間|せいかんくうかん|interstellar space
共変|きょうへん|covariance; covariant
彷徨変異|ほうこうへんい|fluctuation; environmental variation
八丁味噌|はっちょうみそ|haccho miso; dark miso variety produced in Aichi Prefecture
八丁みそ|はっちょうみそ|haccho miso; dark miso variety produced in Aichi Prefecture
種子銀行|しゅしぎんこう|seed bank
軍事衝突|ぐんじしょうとつ|military clash; military conflict; military confrontation
環境変異|かんきょうへんい|environmental variation
障害競走|しょうがいきょうそう|steeplechase (horse race)
障害走|しょうがいそう|hurdle race; hurdling
ハードル競技|ハードルきょうぎ|hurdling; hurdle race
社会基盤|しゃかいきばん|social infrastructure
取引区分|とりひきくぶん|transaction classification; transaction type
仕入単価|しいれたんか|purchase price; unit purchase price
仕入れ単価|しいれたんか|purchase price; unit purchase price
個体変異|こたいへんい|individual variation; environmental variation
贓物|ぞうぶつ|stolen goods
贓物|ぞうもつ|stolen goods
賍物|ぞうぶつ|stolen goods
賍物|ぞうもつ|stolen goods
贓品|ぞうひん|stolen goods
賍品|ぞうひん|stolen goods
刑法学|けいほうがく|criminal jurisprudence
背負ってる|しょってる|to be conceited; to be stuck up; to be full of oneself; to be cocky
フォースと共にあれ|フォースとともにあれ|May the Force be with you (Star Wars)
フォースと共に在れ|フォースとともにあれ|May the Force be with you (Star Wars)
フォースと共にあらんことを|フォースとともにあらんことを|May the Force be with you (Star Wars)
フォースと共に在らんことを|フォースとともにあらんことを|May the Force be with you (Star Wars)
護拳|ごけん|guard (of a sword)
炊事婦|すいじぶ|woman who assists in food preparation
スパ銭|スパせん|large bathhouse with many different services; deluxe public bath
指し棒|さしぼう|pointer; pointing stick
木棺|もっかん|wooden coffin
船殻|せんこく|hull
滴|てき|counter for drops of liquid
海洋化学|かいようかがく|chemical oceanography; marine chemistry
安南|アンナン|Annam; old name of Vietnam
海洋工学|かいようこうがく|ocean engineering
船舶工学|せんぱくこうがく|marine engineering; naval architecture
造船学|ぞうせんがく|naval architecture
虚偽報道|きょぎほうどう|false reporting; fake news
フェイクニュース||fake news
フェイク・ニュース||fake news
情報操作|じょうほうそうさ|manipulation of information; spin
偏向報道|へんこうほうどう|biased coverage; biased media account; bias in reporting
報道被害|ほうどうひがい|victimization by media; trial by media; damage caused by exaggerated or false reporting (e.g. that one has committed a crime)
型持ち|かたもち|chaplet (metallurgy)
中子押さえ|なかごおさえ|chaplet (metallurgy)
中子押え|なかごおさえ|chaplet (metallurgy)
虚偽報告|きょぎほうこく|false report
バナバ||giant crape-myrtle (Lagerstroemia speciosa); Queen's crape-myrtle; banabá; Pride of India
アフターサポート||after-sales support; customer service
アフター・サポート||after-sales support; customer service
コメディタッチ||comedic style; humorous; funny; comical
コメディータッチ||comedic style; humorous; funny; comical
コメディ・タッチ||comedic style; humorous; funny; comical
コメディー・タッチ||comedic style; humorous; funny; comical
コンバインドサイクル発電|コンバインドサイクルはつでん|combined cycle power generation
コンバインド・サイクル発電|コンバインドサイクルはつでん|combined cycle power generation
コンバインドサイクル||combined cycle
コンバインド・サイクル||combined cycle
トイレが近い|トイレがちかい|having a small bladder; having an overactive bladder
タク||taxi
ヘクサメトロス||hexameter
α-メチルトリプタミン|アルファメチルトリプタミン|alpha-methyltryptamine; AMT
αメチルトリプタミン|アルファメチルトリプタミン|alpha-methyltryptamine; AMT
児童婚|じどうこん|child marriage
イモい||rustic; unsophisticated; provincial; hick; uncool; unstylish
いもい||rustic; unsophisticated; provincial; hick; uncool; unstylish
ほぼほぼ||almost; nearly
エゴサ||egosearching; egosurfing; self-googling
物のインターネット|もののインターネット|Internet of Things; IoT
モノのインターネット||Internet of Things; IoT
ＩｏＴ|アイオーティー|Internet of Things; IoT
ＩｏＴ|アイオーティ|Internet of Things; IoT
ＩｏＴ|アイ・オー・ティー|Internet of Things; IoT
ＩｏＴ|アイ・オー・ティ|Internet of Things; IoT
インターネットオブシングス||Internet of Things; IoT
インターネット・オブ・シングス||Internet of Things; IoT
屠肉|とにく|butchered meat
敗肉|はいにく|carrion; rotten meat
眼肉|がんにく|meat around the eyes of a fish
Ｇ７|ジーセブン|Group of Seven; G7
Ｇ７|ジー・セブン|Group of Seven; G7
禁薬|きんやく|quitting drugs; going cold turkey; going clean
禁ヤク|きんヤク|quitting drugs; going cold turkey; going clean
非翻訳領域|ひほんやくりょういき|untranslated region; UTR
盗人の上前を取る|ぬすびとのうわまえをとる|taking a cut from a thief's plunder; vile deed
物理量|ぶつりりょう|physical quantity
信用リスク|しんようリスク|credit risk
クレジットデフォルトスワップ||credit default swap; CDS
クレジット・デフォルト・スワップ||credit default swap; CDS
天中殺|てんちゅうさつ|inauspicious time in four pillar astrology
氷棚|ひょうほう|ice shelf
ガス入り|ガスいり|gas-filled (lamp, tube, counter, etc.)
ガス入り|ガスいり|carbonated water
期限を切る|きげんをきる|to set a deadline; to fix a time limit
メルカリ震度|メルカリしんど|Mercalli intensity (earthquake)
トンツー||dots and dashes; Morse code
トンツー||radio telegraphy
トン・ツー||dots and dashes; Morse code
トン・ツー||radio telegraphy
トン||dot (in Morse code)
地質年代学|ちしつねんだいがく|geochronology
層序|そうじょ|succession of strata; stratigraphy
梅毒腫|ばいどくしゅ|syphiloma
丈母|じょうぼ|wife's mother; mother-in-law
岳母|がくぼ|wife's mother; mother-in-law
丈人|じょうじん|elder; senior
丈人|じょうじん|wife's father; father-in-law
自治寮|じちりょう|student hostel partly managed by the residents
地層累重の法則|ちそうるいじゅうのほうそく|law of superposition; principle of superposition
軽車|けいしゃ|quick and lightweight car
追いかけ回す|おいかけまわす|to chase around
追い掛け回す|おいかけまわす|to chase around
追いかけまわす|おいかけまわす|to chase around
追掛け回す|おいかけまわす|to chase around
二次利用|にじりよう|secondary use; reuse
截枝|せっし|pruning tree branches to encourage new growth
切枝|せっし|pruning tree branches to encourage new growth
武士の商法|ぶしのしょうほう|amateurish business methods; bad business sense
截頭|せっとう|cutting off the head
截頭|せっとう|shaping the flowers and leaves of a plant
切頭|せっとう|cutting off the head
切頭|せっとう|shaping the flowers and leaves of a plant
裁ち落とし|たちおとし|cutting off the edges (printing, sewing, cooking, etc.)
裁ち落とし|たちおとし|snippets; trimmings; cuttings
裁ち落し|たちおとし|cutting off the edges (printing, sewing, cooking, etc.)
裁ち落し|たちおとし|snippets; trimmings; cuttings
裁落とし|たちおとし|cutting off the edges (printing, sewing, cooking, etc.)
裁落とし|たちおとし|snippets; trimmings; cuttings
断ち落とし|たちおとし|cutting off the edges (printing, sewing, cooking, etc.)
断ち落とし|たちおとし|snippets; trimmings; cuttings
断截|だんせつ|cutting; cutting off; severing
断切|だんせつ|cutting; cutting off; severing
殺屋|そぎや|clearance store
殺ぎ屋|そぎや|clearance store
削屋|そぎや|clearance store
ぞっき屋|ぞっきや|store that sells remaindered book or magazines
ぞっき本|ぞっきぼん|remaindered books; remainders
ゾッキ本|ゾッキぼん|remaindered books; remainders
ぞっき||selling something for cheap (e.g. books); selling at a loss; dumping
ゾッキ||selling something for cheap (e.g. books); selling at a loss; dumping
バッセン||batting practice facility; batting practice center; batting cage
紙切りナイフ|かみきりナイフ|paper cutter; paper knife
バランスを失う|バランスをうしなう|to lose balance
とつおいつ||irresolutely; hesitatingly; undecidedly
ヒップアップ||lifting one's buttocks (e.g. through exercise); getting a perkier bum; getting rid of sagging buttocks
ヒップ・アップ||lifting one's buttocks (e.g. through exercise); getting a perkier bum; getting rid of sagging buttocks
執刀医|しっとうい|surgeon
萵苣|ちしゃ|lettuce
萵苣|ちさ|lettuce
チシャ||lettuce
零集合|れいしゅうごう|null set; set of measure zero
見終える|みおえる|to finish watching (e.g. a movie)
ブーブークッション||whoopee cushion; poo-poo cushion; farting bag
ブーブー・クッション||whoopee cushion; poo-poo cushion; farting bag
威嚇行動|いかくこうどう|threat behavior; show of force; deimatic behavior
集成材|しゅうせいざい|laminated wood; laminated lumber
揉まれる|もまれる|to be knocked about; to be tossed about; to be jostled
揉まれる|もまれる|to experience hardships; to be sorely tried
好きすぎる|すきすぎる|to like too much; to like to excess; to adore
好き過ぎる|すきすぎる|to like too much; to like to excess; to adore
鬼電|おにでん|calling someone over the phone many times
鬼メール|おにメール|e-mailing or texting someone many times
因み|ちなみ|association; link; connection
因み|ちなみ|pledge (esp. for marriage); promise
ベイクドポテト||baked potato
ベイクド・ポテト||baked potato
電子配置|でんしはいち|electron configuration
自宅安静|じたくあんせい|resting at home
目には目を|めにはめを|an eye for an eye
除毛|じょもう|(non-permanent) hair removal; depilation
航空管制|こうくうかんせい|air traffic control; ATC
占領者|せんりょうしゃ|occupier; occupying forces
脱垂|だっすい|prolapse
脱船|だっせん|jumping ship
多党|たとう|multiple political parties
履き捨てる|はきすてる|to wear out and discard
履き捨てる|はきすてる|to kick off (e.g. shoes); to fling off
履捨てる|はきすてる|to wear out and discard
履捨てる|はきすてる|to kick off (e.g. shoes); to fling off
パソ通|パソつう|online communications; personal computer communications (esp. pre-Internet); pre-Internet online service
ビニコン||convenience store
飯テロ|めしテロ|food porn; intensive appetite stimulation
裏ＤＶＤ|うらディーブイディー|black market adult DVD
アフターピル||morning-after pill
アフター・ピル||morning-after pill
別電|べつでん|separate telegram; different telegram
建設工事保険|けんせつこうじほけん|builder's risk insurance; construction insurance
種麹|たねこうじ|fermentation starter; yeast starter; seed malt
くしゅくしゅ||crumply (cloth, clothing, etc.); ruffled
くしゅくしゅ||itchy and runny (nose)
自伝文学|じでんぶんがく|autobiography; autobiographical literature
睨み倒す|にらみたおす|to stare someone down; to outstare
にらみ倒す|にらみたおす|to stare someone down; to outstare
ティタノボア||Titanoboa (extinct genus of snakes)
冪根|べきこん|nth root
酢水|すみず|vinegar diluted with water
手酢|てず|vinegared water, used for dampening the hands when making sushi
テキストユーザインタフェース||text user interface; TUI
テキスト・ユーザ・インタフェース||text user interface; TUI
組み込みシステム|くみこみシステム|embedded system
非自明|ひじめい|nontrivial (e.g. solution); non-obvious
ディッキー||dickey (garment); dicky; dickie; tuxedo front; tux front
睨める|ねめる|to glare at; to scowl at; to glower at
睨める|ねめる|to stare intensely at; to examine carefully
レトロニム||retronym
薄明光線|はくめいこうせん|crepuscular rays; sunbeams
浅煎り|あさいり|light roast (coffee)
中煎り|なかいり|medium roast (coffee)
深煎り|ふかいり|dark roast (coffee)
所得再分配|しょとくさいぶんぱい|income redistribution
スケアクロー||scarecrow
スケアクロー||person dressed in rags; shabby-looking person
通過者|つうかしゃ|acceptee; accepted candidate
３Ｄプリント|スリーディープリント|3D printing
三次元プリンター|さんじげんプリンター|3D printer
三次元プリンタ|さんじげんプリンタ|3D printer
３Ｄ印刷機|スリーディーいんさつき|3D printer
３Ｄ眼鏡|スリーディーめがね|3D glasses
３Ｄメガネ|スリーディーメガネ|3D glasses
３Ｄグラス|スリーディーグラス|3D glasses
３Ｄ酔い|スリーディーよい|virtual reality sickness; 3D sickness
３Ｄカメラ|スリーディーカメラ|3D camera; stereo camera
３Ｄテレビ|スリーディーテレビ|3D television
３Ｄグラフィックス|スリーディーグラフィックス|3D graphics
プロジェクションマッピング||projection mapping
プロジェクション・マッピング||projection mapping
３Ｄプロジェクションマッピング|スリーディープロジェクションマッピング|3D projection mapping; projection mapping
３Ｄプロジェクションマッピング|スリーディー・プロジェクション・マッピング|3D projection mapping; projection mapping
手を休める|てをやすめる|to rest (from work, studying, etc.); to take a break
電照菊|でんしょうぎく|chrysanthemum grown with artificial light
白鷴|はっかん|silver pheasant (Lophura nycthemera)
ハッカン||silver pheasant (Lophura nycthemera)
双子星|ふたごぼし|binary star
カストル||Castor (star in the constellation Gemini); Alpha Geminorum
ポルックス||Pollux (star in the constellation Gemini); Beta Geminorum
カノープス||Canopus (star in the constellation Carina); Alpha Carinae
プロキオン||Procyon (star in the constellation Canis Minor); Alpha Canis Minoris
スピカ||Spica (star in the constellation Virgo); Alpha Virginis
括弧付き|かっこつき|quote-unquote; so-called
括弧付き|かっこつき|bracketed
かっこ付き|かっこつき|quote-unquote; so-called
かっこ付き|かっこつき|bracketed
括弧つき|かっこつき|quote-unquote; so-called
括弧つき|かっこつき|bracketed
カッコ付き|カッコつき|quote-unquote; so-called
カッコ付き|カッコつき|bracketed
いんちき臭い|いんちきくさい|fishy; dubious; questionable; false-looking
インチキ臭い|インチキくさい|fishy; dubious; questionable; false-looking
デネブ||Deneb (star in the constellation Cygnus); Alpha Cygni
アケルナル||Achernar (star in the constellation Eridanus); Alpha Eridani
フォーマルハウト||Fomalhaut (star in the constellation Piscis Austrinus); Alpha Piscis Austrini
多食亜目|たしょくあもく|Polyphaga (suborder of beetles)
ニレ立ち枯れ病|ニレたちがれびょう|Dutch elm disease
知識基盤社会|ちしききばんしゃかい|knowledge-based society
横風|よこかぜ|crosswind; side wind
身が引き締まる|みがひきしまる|to become tense; to become serious; to become sober
身が引き締まる|みがひきしまる|sobering; bracing
身が引締まる|みがひきしまる|to become tense; to become serious; to become sober
身が引締まる|みがひきしまる|sobering; bracing
フォボス||Phobos (moon of Mars)
ダイモス||Deimos (moon of Mars)
デイモス||Deimos (moon of Mars)
エウロパ||Europa (moon of Jupiter)
カロン||Charon (moon of Pluto)
カロン||Charon (Greek god)
悦に浸る|えつにひたる|to be pleased; to gloat; to glow with self-satisfaction
ダブり||overlap
ダブり||duplication; doubling
ダブリ||overlap
ダブリ||duplication; doubling
二等星|にとうせい|second magnitude star
２等星|にとうせい|second magnitude star
海王星外天体|かいおうせいがいてんたい|trans-Neptunian object; transneptunian object; TNO
リクスー||standard formal wear worn by students, usu. when going to interviews
ジュレ||jello; gelatin dessert; jelly
ぼろぼろの木|ぼろぼろのき|Schoepfia jasminodora (tree of family Schoepfiaceae)
ボロボロの木|ボロボロのき|Schoepfia jasminodora (tree of family Schoepfiaceae)
ボロボロノキ||Schoepfia jasminodora (tree of family Schoepfiaceae)
低予算|ていよさん|low budget; low-budget
ラジオ星|ラジオせい|radio star
バーナード星|バーナードせい|Barnard's Star (star in the constellation Ophiuchus)
様相論理|ようそうろんり|modal logic
ハーデース||Hades (Greek god)
ハーデース||Hades; the underworld (in Greek mythology)
ハデス||Hades (Greek god)
ハデス||Hades; the underworld (in Greek mythology)
三角ベース|さんかくベース|baseball played without a second base (children's game)
早発|そうはつ|departing early in the morning
早発|そうはつ|departing earlier than scheduled
早発|そうはつ|premature (e.g. of an disease); early onset
打製石器|だせいせっき|chipped stone tool; flaked stone tool
ペルセポネー||Persephone (Greek goddess)
ペルセポネ||Persephone (Greek goddess)
ペルセフォネ||Persephone (Greek goddess)
クロノス||Cronus (Greek god); Kronos
ガイア仮説|ガイアかせつ|Gaia hypothesis; Gaia theory; Gaia principle
ガイア理論|ガイアりろん|Gaia theory; Gaia principle; Gaia hypothesis
打製|だせい|made by hitting (e.g. striking stone flakes from a tool stone); made using lithic reduction
反転フラップ式案内表示機|はんてんフラップしきあんないひょうじき|split-flap display
アメリカレア||greater rhea (Rhea americana); common rhea; American rhea
アメリカ・レア||greater rhea (Rhea americana); common rhea; American rhea
打ち欠く|うちかく|to break off; to knock off
打ち欠く|うちかく|to create a false eye by sacrificing a stone (in go)
打欠く|うちかく|to break off; to knock off
打欠く|うちかく|to create a false eye by sacrificing a stone (in go)
円唇|えんしん|rounding of the lips; rounded (e.g. vowel)
洗面用具|せんめんようぐ|toiletries
麩菓子|ふがし|candy made from wheat gluten; wheat-gluten snack
ふ菓子|ふがし|candy made from wheat gluten; wheat-gluten snack
麸菓子|ふがし|candy made from wheat gluten; wheat-gluten snack
あんず飴|あんずあめ|candy-coated fruit (usu. a plum) on a stick
太陽系外縁天体|たいようけいがいえんてんたい|trans-Neptunian object; transneptunian object; TNO
裸の王様|はだかのおうさま|person of high standing facing no opposition and with a warped view of reality
裸の王様|はだかのおうさま|The Emperor's New Clothes (tale by Hans Christian Andersen)
はだかの王様|はだかのおうさま|person of high standing facing no opposition and with a warped view of reality
はだかの王様|はだかのおうさま|The Emperor's New Clothes (tale by Hans Christian Andersen)
はだかの王さま|はだかのおうさま|person of high standing facing no opposition and with a warped view of reality
はだかの王さま|はだかのおうさま|The Emperor's New Clothes (tale by Hans Christian Andersen)
凸包|とつほう|convex hull
実績を残す|じっせきをのこす|to accomplish something; to leave a mark; to make an impression; to build a track record
自己肯定感|じここうていかん|self-esteem; feeling of self-approval
一帯一路|いったいいちろ|One Belt, One Road (Chinese development strategy); OBOR
ランサムウェア||ransomware
ランサムウエア||ransomware
共謀罪|きょうぼうざい|(criminal) conspiracy; conspiracy to commit a crime
２ＤＫ|にディーケー|two rooms and a combination dining-kitchen
２Ｄ|ツーディー|2D; two dimensional
コブサラダ||Cobb salad
コブ・サラダ||Cobb salad
チョップサラダ||chopped salad
チョップドサラダ||chopped salad
チョップ・サラダ||chopped salad
チョップド・サラダ||chopped salad
ポートレート写真|ポートレートしゃしん|portrait (photo)
サルシッチャ||salsiccia; Italian sausage
アーリオオーリオ||garlic-infused olive oil
アーリオ・オーリオ||garlic-infused olive oil
ダークチョコレート||dark chocolate
ダーク・チョコレート||dark chocolate
ビターチョコ||dark chocolate (with high cocoa content)
ビター・チョコ||dark chocolate (with high cocoa content)
チョコレートパン||bread with chocolate filling; chocolate bread
チョコレート・パン||bread with chocolate filling; chocolate bread
チョコパン||bread with chocolate filling; chocolate bread
チョコ・パン||bread with chocolate filling; chocolate bread
罰打|ばつだ|penalty (golf); penalty stroke
聖画|せいが|religious painting; sacred painting
セミスイートチョコレート||semisweet chocolate
セミスイート・チョコレート||semisweet chocolate
街頭アンケート|がいとうアンケート|street survey; opinion poll performed on street; on-street questionnaire
街頭インタビュー|がいとうインタビュー|man-on-the-street interview; vox populi; vox pop; curbside interview
ショース||hose; long stockings (esp. for men)
ホーズ||hose; long socks; long stockings; hosiery
農民工|のうみんこう|migrant worker from the countryside (in China)
スイートチョコレート||dark chocolate (with high sugar content)
スイート・チョコレート||dark chocolate (with high sugar content)
ぶどう飴|ぶどうあめ|candy-coated grapes on a stick
いちご飴|いちごあめ|candy-coated strawberry on a stick
ギルティ||guilty
ギルティー||guilty
エロビデ||pornographic film; adult video
ネット弁慶|ネットべんけい|keyboard warrior; Internet tough guy
ディアーナ||Diana (Roman goddess)
ディーアーナ||Diana (Roman goddess)
ディアナ||Diana (Roman goddess)
ダイアナ||Diana (Roman goddess)
難を逃れる|なんをのがれる|to avoid misfortune; to escape danger
難をのがれる|なんをのがれる|to avoid misfortune; to escape danger
調査船|ちょうさせん|research vessel
占城|チャンパ|Champa (former kingdom(s) in central Vietnam)
占城|せんじょう|Champa (former kingdom(s) in central Vietnam)
行きしな|いきしな|(on) the way; (on) one's way; (en) route
行きしな|ゆきしな|(on) the way; (on) one's way; (en) route
民工|みんこう|(rural) migrant worker (in China)
プロセルピナ||Proserpina (Roman goddess); Proserpine
ヤーヌス||Janus (Roman god)
ヤヌス||Janus (Roman god)
冥王星型天体|めいおうせいがたてんたい|plutoid; ice dwarf; trans-Neptunian dwarf planet
独裁主義|どくさいしゅぎ|dictatorship; despotism
すずの兵隊|すずのへいたい|tin soldier
スズの兵隊|スズのへいたい|tin soldier
錫の兵隊|すずのへいたい|tin soldier
オガネソン||oganesson (Og)
ラストオーダー||last call (in bar, restaurant, etc.); last order
ラスト・オーダー||last call (in bar, restaurant, etc.); last order
不遡及|ふそきゅう|non-retroactivity
作用線|さようせん|line of action
駆風薬|くふうやく|carminative; gripe water
手すり子|てすりこ|baluster; banister
手摺り子|てすりこ|baluster; banister
バラスター||baluster; banister
延し棒|のしぼう|rolling pin
伸し棒|のしぼう|rolling pin
のし棒|のしぼう|rolling pin
伸ばし棒|のばしぼう|rolling pin
伸ばし棒|のばしぼう|extension bar
伸ばし棒|のばしぼう|katakana-hiragana prolonged sound mark
のばし棒|のばしぼう|rolling pin
のばし棒|のばしぼう|extension bar
のばし棒|のばしぼう|katakana-hiragana prolonged sound mark
延ばし棒|のばしぼう|rolling pin
延ばし棒|のばしぼう|extension bar
延ばし棒|のばしぼう|katakana-hiragana prolonged sound mark
海外駐在員|かいがいちゅうざいいん|overseas representative; expatriate employee; expatriate staff
哀れがる|あわれがる|to feel sorry for; to pity
応射|おうしゃ|return fire; shooting back
斜め顔|ななめがお|diagonal view of face (artist term); three-quarter view of face
貧乏削り|びんぼうけずり|pencil sharpened at both ends; sharpening a pencil at both ends
びんぼう削り|びんぼうけずり|pencil sharpened at both ends; sharpening a pencil at both ends
泥棒削り|どろぼうけずり|pencil sharpened at both ends; sharpening a pencil at both ends
のたのた||idling away time; unproductively
のたのた||slowly (moving); heavily; ponderously
プランＢ|プランビー|plan B
写真乳剤|しゃしんにゅうざい|photographic emulsion
十指に余る|じっしにあまる|to number more than ten; to be numerous
再利用可能|さいりようかのう|reusable; recyclable
気泡風呂|きほうぶろ|Jacuzzi; whirlpool bath
写真乾板|しゃしんかんぱん|dry plate (photography)
肘張る|ひじばる|to stick out one's elbows
肘張る|ひじばる|to be obstinate; to be haughty
片肘|かたひじ|one elbow
片肱|かたひじ|one elbow
馬毛|うまげ|horsehair; horse hair; hair from mane and tail used for brushes and string instrument bows
バブルバス||bubble bath; bubble bath soap
バブルバス||jacuzzi; whirlpool path
バブル・バス||bubble bath; bubble bath soap
バブル・バス||jacuzzi; whirlpool path
餌やり|えさやり|feeding (animals); provisioning
餌遣り|えさやり|feeding (animals); provisioning
エサ遣り|エサやり|feeding (animals); provisioning
回頭|かいとう|turning round (a ship); changing course; veering
萌動|ほうどう|sprouting; budding
反競争的行為|はんきょうそうてきこうい|anticompetitive behaviour; anticompetitive behavior; anticompetitive practice
人気を呼ぶ|にんきをよぶ|to capture public interest; to enjoy popularity
無私無欲|むしむよく|selflessness; unselfishness
猩猩朱鷺|しょうじょうとき|scarlet ibis (Eudocimus ruber)
猩々朱鷺|しょうじょうとき|scarlet ibis (Eudocimus ruber)
ショウジョウトキ||scarlet ibis (Eudocimus ruber)
ハードルを上げる|ハードルをあげる|to raise the bar
血祭りにあげる|ちまつりにあげる|to kill an enemy soldier before the start of a battle to raise spirits
血祭りにあげる|ちまつりにあげる|to kill viciously
血祭りにあげる|ちまつりにあげる|to victimize; to torment; to lay into; to give (someone) hell; to vilify
血祭りに上げる|ちまつりにあげる|to kill an enemy soldier before the start of a battle to raise spirits
血祭りに上げる|ちまつりにあげる|to kill viciously
血祭りに上げる|ちまつりにあげる|to victimize; to torment; to lay into; to give (someone) hell; to vilify
血祭にあげる|ちまつりにあげる|to kill an enemy soldier before the start of a battle to raise spirits
血祭にあげる|ちまつりにあげる|to kill viciously
血祭にあげる|ちまつりにあげる|to victimize; to torment; to lay into; to give (someone) hell; to vilify
血祭に上げる|ちまつりにあげる|to kill an enemy soldier before the start of a battle to raise spirits
血祭に上げる|ちまつりにあげる|to kill viciously
血祭に上げる|ちまつりにあげる|to victimize; to torment; to lay into; to give (someone) hell; to vilify
数秘学|すうひがく|numerology
話題を呼ぶ|わだいをよぶ|to attract public attention; to create a stir; to arouse interest
風倒木|ふうとうぼく|tree blown down by the wind
司政官|しせいかん|provisional administrator in occupied territory during WWII
闇ブローカー|やみブローカー|black-market broker
貫板|ぬきいた|rough-cut board; construction lumber
貫板|ぬきいた|batten; tie beam
計画都市|けいかくとし|planned city
専政|せんせい|autocracy
フォーミュラリー||formulary
ノイラミニダーゼ||neuraminidase
ノイラミニターゼ||neuraminidase
シアリダーゼ||sialidase
超高齢化|ちょうこうれいか|extreme population aging (ageing)
臨床現場|りんしょうげんば|clinical site; location of medical procedure
遠隔診療|えんかくしんりょう|remote diagnosis
若魚|わかうお|young fish
若魚子|わかなご|young Japanese amberjack (species of yellowtail, Seriola quinqueradiata)
ワカナゴ||young Japanese amberjack (species of yellowtail, Seriola quinqueradiata)
合成生物学|ごうせいせいぶつがく|synthetic biology
遠隔診断|えんかくしんだん|telediagnosis
意思が強い|いしがつよい|determined; strong-willed
先発品|せんぱつひん|original drug; originator drug
流通戦略|りゅうつうせんりゃく|distribution strategy; channel strategy
流通網|りゅうつうもう|distribution network; distribution channels
最東|さいとう|easternmost
最西|さいせい|westernmost
腹を下す|はらをくだす|to have diarrhea
腹をくだす|はらをくだす|to have diarrhea
先発医薬品|せんぱついやくひん|original drug; originator drug
横貫|おうかん|traversing horizontally; passing through laterally; running east to west
開かずの間|あかずのま|room that is forbidden to enter; locked room; unopened room
あかずの間|あかずのま|room that is forbidden to enter; locked room; unopened room
空中浮遊生物|くうちゅうふゆうせいぶつ|aeroplankton
薮野兎|やぶのうさぎ|European hare (Lepus europaeus); brown hare
藪野兎|やぶのうさぎ|European hare (Lepus europaeus); brown hare
ヤブノウサギ||European hare (Lepus europaeus); brown hare
経済社会学|けいざいしゃかいがく|economic sociology
冠番組|かんむりばんぐみ|namesake program; namesake show; TV or radio program named after the main performer or a sponsor
国家資格|こっかしかく|national certification; national qualification; government certification
激おこぷんぷん丸|げきおこぷんぷんまる|state of extreme rage
激おこプンプン丸|げきおこプンプンまる|state of extreme rage
外光派|がいこうは|cult of the open air; pleinairism; pleinairisme
外光派|がいこうは|painter of pleinairisme; pleinairist
臆病風に吹かれる|おくびょうかぜにふかれる|to become scared; to have an attack of nerves; to have a yellow streak; to chicken out; to run out of courage
欽定訳聖書|きんていやくせいしょ|King James Bible; King James Version; Authorized Version
画餅に帰す|がべいにきす|to come to nothing; to end in failure; to fall through
淡麗|たんれい|smooth and refreshing (of sake); light with a clean finish
歩割|ぶわり|rate; ratio; percentage
歩割|ぶわり|commission; poundage; percentage
分割|ぶわり|rate; ratio; percentage
分割|ぶわり|commission; poundage; percentage
凭せる|もたせる|to lean (something) against; to set against; to prop up against
パリ協定|パリきょうてい|Paris Agreement (on climate change)
スノーノイズ||noise (video); snow
スノー・ノイズ||noise (video); snow
算盤を弾く|そろばんをはじく|to count on the abacus
算盤を弾く|そろばんをはじく|to calculate cost-benefit; to calculate profitability
電卓を叩く|でんたくをたたく|to use a calculator
電卓を叩く|でんたくをたたく|to calculate cost-benefit; to calculate profitability
外国人タレント|がいこくじんタレント|non-Japanese celebrity; foreigner celebrity
クリーンブース||clean booth
クリーン・ブース||clean booth
製麹|せいきく|koji production
変声|へんせい|voice change; voice break
パンパンガ語|パンパンガご|Kapampangan (language); Pampangan (language)
縁故主義|えんこしゅぎ|nepotism
激低|げきひく|extremely low
リーファーコンテナ||reefer container; refrigerated shipping container
リーファーコンテナー||reefer container; refrigerated shipping container
リーファー・コンテナ||reefer container; refrigerated shipping container
リーファー・コンテナー||reefer container; refrigerated shipping container
リーファー||reefer (jacket)
リーファー||reefer; refrigerator; refrigerator car
気味の悪い|きみのわるい|creepy (feeling); uneasy (feeling); bad (feeling); giving one the creeps; hideous; scaring; weird
鏡立て|かがみたて|mirror stand
鏡たて|かがみたて|mirror stand
魯魚亥豕|ろぎょがいし|miswriting a word; using the wrong kanji to write a word
跳躍競技|ちょうやくきょうぎ|jumping event (track and field)
踏み越す|ふみこす|to step out of the ring; to put one's foot outside the ring
踏越す|ふみこす|to step out of the ring; to put one's foot outside the ring
パンチングメタル||perforated metal; punched metal
パンチング・メタル||perforated metal; punched metal
バッフル||baffle (in a speaker)
フィスティング||punching (a ball); fisting
フィスティング||fisting (sexual activity)
シールドガス||shielding gas (in welding)
シールガス||shielding gas (in welding)
シールド・ガス||shielding gas (in welding)
シール・ガス||shielding gas (in welding)
ノーテーション||notation
ノーティカルマイル||nautical mile
ノーティカル・マイル||nautical mile
ノーティカル||nautical
不聴|ノーテン|not fishing; needing more than one tile to win
ノー聴|ノーテン|not fishing; needing more than one tile to win
心拍出量|しんはくしゅつりょう|cardiac output
拍出|はくしゅつ|ejection (e.g. cardiac output)
汎アジア主義|はんアジアしゅぎ|Pan-Asianism
パンアメリカンハイウェー||Pan-American Highway
パンアメリカンハイウェイ||Pan-American Highway
パンアメリカン・ハイウェー||Pan-American Highway
パンアメリカン・ハイウェイ||Pan-American Highway
油茅|あぶらがや|abura-gaya (Scirpus wichurai)
油萱|あぶらがや|abura-gaya (Scirpus wichurai)
アブラガヤ||abura-gaya (Scirpus wichurai)
あばずれ女|あばずれおんな|coquette; flirt; vamp; minx; tease
あば擦れ女|あばずれおんな|coquette; flirt; vamp; minx; tease
阿婆擦れ女|あばずれおんな|coquette; flirt; vamp; minx; tease
味利き|あじきき|tasting
味利き|あじきき|taster (of sake, wine, etc.)
味聞き|あじきき|tasting
味聞き|あじきき|taster (of sake, wine, etc.)
もみ海苔|もみのり|crumbled grilled nori
揉み海苔|もみのり|crumbled grilled nori
ケスタ||cuesta
フードバンク||food bank
フード・バンク||food bank
食糧銀行|しょくりょうぎんこう|food bank
一巡り|ひとめぐり|a round; a turn; going around; making a round
一巡り|ひとめぐり|first anniversary of a person's death
ひと巡り|ひとめぐり|a round; a turn; going around; making a round
ひと巡り|ひとめぐり|first anniversary of a person's death
一周り|ひとめぐり|a round; a turn; going around; making a round
一周り|ひとめぐり|first anniversary of a person's death
遠来の客|えんらいのきゃく|visitor from afar; foreign visitor
ドリルビット||drill bit
ドリル・ビット||drill bit
夏休みの友|なつやすみのとも|booklet with homework assignments for the summer vacation
クオックグー||Vietnamese alphabet
クオック・グー||Vietnamese alphabet
シネマベリテ||cinéma vérité; style of documentary film making
シネマヴェリテ||cinéma vérité; style of documentary film making
シネマ・ベリテ||cinéma vérité; style of documentary film making
シネマ・ヴェリテ||cinéma vérité; style of documentary film making
自動火器|じどうかき|automatic firearm
竽|う|yu; free reed wind instrument used in ancient China and Nara period Japan
聖林|ハリウッド|Hollywood
潮を吹く|しおをふく|to blow water (whale, blowhole, etc.); to spout
潮を吹く|しおをふく|to squirt (female ejaculation)
潮を噴く|しおをふく|to blow water (whale, blowhole, etc.); to spout
潮を噴く|しおをふく|to squirt (female ejaculation)
潮吹き穴|しおふきあな|blowhole
潮吹穴|しおふきあな|blowhole
セントキッツネイビス||Saint Kitts and Nevis; Saint Christopher and Nevis
セントキッツ・ネイビス||Saint Kitts and Nevis; Saint Christopher and Nevis
ファンダム||fandom
力積|りきせき|impulse
同ポジ|どうポジ|shots taken with camera in the same position
磯辺餅|いそべもち|fried mochi covered in soy sauce and wrapped in nori
四畳半趣味|よじょうはんしゅみ|enjoying food, drink and entertainment in a small room
人工頭脳学|じんこうずのうがく|cybernetics
氏子総代|うじこそうだい|parishioner representative
ハングパーラメント||hung parliament
ハング・パーラメント||hung parliament
無柄|むへい|sessile; stalkless
暗数|あんすう|dark figure (esp. of crime); dark number; hidden figure; difference between the actual and reported figure
京城|けいじょう|imperial palace
京城|けいじょう|capital; metropolis
京城|けいじょう|Keijou (name given to Seoul during the Japanese occupation)
アンドゥイエット||andouillette; French sausage filled with pork and tripe
アンデュイエット||andouillette; French sausage filled with pork and tripe
並行複発酵|へいこうふくはっこう|multiple parallel fermentation (esp. in sake brewing)
すっくり||straight; upright; erect
すっくり||all; completely; thoroughly
付け打ち|つけうち|sounding of the wooden clappers (kabuki)
附け打ち|つけうち|sounding of the wooden clappers (kabuki)
唇音化|しんおんか|labialization
口蓋化|こうがいか|palatalization
迷子石|まいごいし|glacial erratic; erratic boulder
付け木|つけき|wooden blocks used as clappers (kabuki)
附け木|つけき|wooden blocks used as clappers (kabuki)
付け板|つけいた|wooden board used for sounding clappers (kabuki)
附け板|つけいた|wooden board used for sounding clappers (kabuki)
ツケ板|ツケいた|wooden board used for sounding clappers (kabuki)
エナジードリンク||energy drink
エナジー・ドリンク||energy drink
カレーシチュー||curry and rice (esp. on school menus)
カレー・シチュー||curry and rice (esp. on school menus)
アンカーパーソン||anchorperson; anchorman
アンカーパーソン||reporter who gathers material from various contributors
アンカー・パーソン||anchorperson; anchorman
アンカー・パーソン||reporter who gathers material from various contributors
マントラ||mantra
脱進機|だっしんき|escapement (clock mechanism)
大コケ|おおコケ|flop (e.g. movie); total failure; box office bomb
モールド||mold; mould; template
モールド||figure; shape; form; character; personality
壌土|じょうど|soil
壌土|じょうど|loamy soil; loam; soil with clay content of 25-37.5%
神の思し召し|かみのおぼしめし|God's will; Heaven's will
神の思召し|かみのおぼしめし|God's will; Heaven's will
神の思召|かみのおぼしめし|God's will; Heaven's will
新世界秩序|しんせかいちつじょ|New World Order; NWO
深層Ｗｅｂ|しんそうウェブ|deep web; invisible web
深層ウェブ|しんそうウェブ|deep web; invisible web
給食係|きゅうしょくがかり|lunch monitor; student responsible for school lunch distribution and clean-up
論理学者|ろんりがくしゃ|logician
水上機母艦|すいじょうきぼかん|seaplane carrier
艦型|かんけい|type of warship
艦型|かんけい|model warship
森梟|もりふくろう|tawny owl (Strix aluco); brown owl
森梟|モリフクロウ|tawny owl (Strix aluco); brown owl
粗粒玄武岩|そりゅうげんぶがん|dolerite; diabase
輝緑岩|きりょくがん|diabase; dolerite
粗粒|そりゅう|coarse-grained
風成|ふうせい|aeolian; eolian; formed by the wind
見っともいい|みっともいい|decent; respectable; dignified; becoming; seemly
仁川|インチョン|Incheon (Korea); Inchon
仁川|じんせん|Incheon (Korea); Inchon
福音伝道|ふくいんでんどう|evangelism
ドレライト||dolerite; diabase
風成土|ふうせいど|aeolian soil.
風積土|ふうせきど|aeolian soil
土性|どせい|soil texture
土性|どせい|earth (in Wu Xing)
司法妨害|しほうぼうがい|obstruction of justice
国家情報長官|こっかじょうほうちょうかん|Director of National Intelligence (USA); DNI
面対称|めんたいしょう|plane symmetry; symmetry with respect to a plane
チャイナ服|チャイナふく|qipao; cheongsam; mandarin dress
量水標|りょうすいひょう|water level marker; staff gauge
量水器|りょうすいき|water meter
水準点|すいじゅんてん|benchmark (surveying); bench mark
水準原点|すいじゅんげんてん|primary benchmark (surveying); fundamental benchmark
測量標|そくりょうひょう|survey marker; station marker
タブロイド判|タブロイドばん|tabloid format (newspaper, etc.)
非道徳的|ひどうとくてき|immoral; unethical
非政治的|ひせいじてき|apolitical; nonpolitical
諳んずる|そらんずる|to memorize; to memorise; to recite from memory
父殺し|ちちごろし|patricide
直訳体|ちょくやくたい|literal style (of translation); metaphrastic style
曝す|さぼす|to expose to the wind; to dry (something) in the wind
乾す|さぼす|to expose to the wind; to dry (something) in the wind
ぼかし染め|ぼかしぞめ|gradation dyeing
暈し染め|ぼかしぞめ|gradation dyeing
ぼかし染|ぼかしぞめ|gradation dyeing
暈し染|ぼかしぞめ|gradation dyeing
市内電話|しないでんわ|local call (telephone)
三連音符|さんれんおんぷ|triplet
日暈|ひがさ|solar halo
日暈|にちうん|solar halo
日がさ|ひがさ|solar halo
父親殺し|ちちおやごろし|patricide
濃色|のうしょく|deep color (colour)
屈伸性|くっしんせい|elasticity
ネクストバッターズサークル||on-deck circle
ネクスト・バッターズ・サークル||on-deck circle
メール会員|メールかいいん|mailing-list member
憎悪表現|ぞうおひょうげん|hate speech
腕ひしぎ|うでひしぎ|armlock
腕挫ぎ|うでひしぎ|armlock
転び公妨|ころびこうぼう|falsely-provoked arrest for obstruction; police pretending to be knocked down so as to have grounds for an arrest
祖神|そしん|ancestor worshipped as a deity
祖神|そじん|ancestor worshipped as a deity
隠し録り|かくしどり|making a secret recording
盗み録り|ぬすみどり|making a secret recording
公妨|こうぼう|interference with a public servant in the execution of his or her duties
妨害罪|ぼうがいざい|(crime of) obstruction; obstruction charge
就農|しゅうのう|working in agriculture
盗み撮り|ぬすみどり|taking pictures secretly; taking a sneak shot
天府|てんぷ|balance wheel (in a watch); balance
天桴|てんぷ|balance wheel (in a watch); balance
テンプ||balance wheel (in a watch); balance
髯発条|ひげぜんまい|balance spring; hairspring
ヒゲゼンマイ||balance spring; hairspring
別件逮捕|べっけんたいほ|arrest on a separate charge
早付け木|はやつけぎ|match (for lighting fires)
早附け木|はやつけぎ|match (for lighting fires)
早付木|はやつけぎ|match (for lighting fires)
早附木|はやつけぎ|match (for lighting fires)
目を晒す|めをさらす|to fix one's eyes on; to stare intently at; to study carefully (with the eyes)
目をさらす|めをさらす|to fix one's eyes on; to stare intently at; to study carefully (with the eyes)
目を曝す|めをさらす|to fix one's eyes on; to stare intently at; to study carefully (with the eyes)
強毒性|きょうどくせい|high virulence; strong toxicity
公務執行妨害罪|こうむしっこうぼうがいざい|obstructing the discharge of official duties; hindering a government official in the execution of his duties
ほっかり||pleasantly (warm)
ほっかり||faintly; lightly
ほっかり||suddenly; unexpectedly
ほっかり||accidentally; carelessly
ほっかり||gaping wide; opening one's mouth wide
油浸|ゆしん|oil immersion
液浸|えきしん|immersion; dipping; in microscopy, immersing both the objective lens and the specimen in a liquid to increase the numerical aperture; in photolithography, filling the air gap between the final lens and the wafer surface with a liquid to increase the resolution
フォトリソグラフィー||photolithography
フォトリソグラフィ||photolithography
中高層|ちゅうこうそう|medium and high-rise (buildings, apartments, etc.)
亜アンチモン酸|あアンチモンさん|antimonious acid; antimonous acid
取り過ぎ|とりすぎ|excessive intake (e.g. coffee)
取り過ぎ|とりすぎ|overbooking
取り過ぎる|とりすぎる|to eat too much of something
取り過ぎる|とりすぎる|to overbook
アンシクロペディスト||the Encyclopédistes
木摺り|きずり|wood lath
木ずり|きずり|wood lath
申込用紙|もうしこみようし|application form
猛炎|もうえん|fierce flames; raging flames
猛焔|もうえん|fierce flames; raging flames
ポンプ車|ポンプしゃ|fire truck (specifically one equipped with a pump); pumper
ガタガタになる||to break down; to collapse; to fall apart
がたがたになる||to break down; to collapse; to fall apart
組み上がる|くみあがる|to be set up (completely); to be put together; to be composed (e.g. type)
組み上る|くみあがる|to be set up (completely); to be put together; to be composed (e.g. type)
含銅|がんどう|cupriferous; containing copper
強盗提灯|がんどうちょうちん|flashlight-like lantern with a freely rotating candle that only directs light forward
龕灯提灯|がんどうちょうちん|flashlight-like lantern with a freely rotating candle that only directs light forward
鼻粘膜|びねんまく|nasal mucous membrane; nasal mucosa
鼻息をうかがう|はないきをうかがう|to sound out a person's feelings; to consult a person's pleasure
鼻息を窺う|はないきをうかがう|to sound out a person's feelings; to consult a person's pleasure
鼻カタル|びカタル|nasal catarrh; rheum; rhinitis; coryza
靴クリーム|くつクリーム|shoe polish; boot polish; shoe cream
崛起|くっき|standing out from the crowd; dominating; rising abruptly
崛起|くっき|towering high
屈起|くっき|standing out from the crowd; dominating; rising abruptly
屈起|くっき|towering high
偶有性|ぐうゆうせい|accidental quality (philosophy, logic); accidence
偶発犯|ぐうはつはん|occasional crime; crime instigated by external circumstances
偶発性|ぐうはつせい|contingency; eventuality
空力|くうりき|aerodynamics
カザフ||Kazakhstan
カザフ||Kazakh people
カザフ語|カザフご|Kazakh (language)
類型論|るいけいろん|typology
類型学|るいけいがく|typology
機会犯|きかいはん|crime instigated by external circumstances
即席に|そくせきに|impromptu; on the spot; off the cuff; ad lib
赤噛み蟻|あかかみあり|tropical fire ant (Solenopsis geminata)
アカカミアリ||tropical fire ant (Solenopsis geminata)
立体美|りったいび|beauty of form or proportion (in a created object); solid beauty
読み通す|よみとおす|to read to the end; to read through; to read from cover to cover
読通す|よみとおす|to read to the end; to read through; to read from cover to cover
忌み子|いみこ|unwanted child; shunned child
子守熊|こもりぐま|koala (Phascolarctos cinereus)
コモリグマ||koala (Phascolarctos cinereus)
無脚|むきゃく|apodal
ボイスチャット||voice chat (e.g. in a video game)
ボイス・チャット||voice chat (e.g. in a video game)
ロボアドバイザー||robo-advisor; automated investment advisor; online investment advisor
交通規制|こうつうきせい|traffic restrictions; traffic control
滝汗|たきあせ|profuse sweating
グラニュール||granule
タイポロジー||typology
ボイチャ||voice chat
タイポグラファー||typographer
アリアニコ||Aglianico (wine grape variety)
モンテプルチャーノ||Montepulciano (wine grape variety)
サンジョヴェーゼ||Sangiovese (wine grape variety)
トレッビアーノ||Trebbiano (wine grape variety)
ネロダーヴォラ||Nero d'Avola (wine grape variety)
ネロダヴォラ||Nero d'Avola (wine grape variety)
ネーロダーヴォラ||Nero d'Avola (wine grape variety)
ネロ・ダーヴォラ||Nero d'Avola (wine grape variety)
ネロ・ダヴォラ||Nero d'Avola (wine grape variety)
ネーロ・ダーヴォラ||Nero d'Avola (wine grape variety)
プリミティーヴォ||Primitivo (wine grape variety)
ネッビオーロ||Nebbiolo (wine grape variety)
バルベーラ||Barbera (wine grape variety)
ドルチェット||Dolcetto (wine grape variety)
ランブルスコ||Lambrusco (wine grape variety)
サグランティーノ||Sagrantino (wine grape variety)
テンプラニーリョ||Tempranillo (wine grape variety)
テンプラニージョ||Tempranillo (wine grape variety)
アイレン||Airén (wine grape variety)
アルバリーニョ||Albariño (wine grape variety); Alvarinho
アルヴァリーニョ||Albariño (wine grape variety); Alvarinho
ベルデホ||Verdejo (wine grape variety)
ヴェルデホ||Verdejo (wine grape variety)
ヴェルディッキオ||Verdicchio (wine grape variety)
プティヴェルド||Petit Verdot (wine grape variety)
プティ・ヴェルド||Petit Verdot (wine grape variety)
マルベック||Malbec (wine grape variety)
カルメネール||Carménère (wine grape variety)
セミヨン||Sémillon (wine grape variety)
ソーヴィニヨンブラン||Sauvignon blanc (wine grape variety)
ソーヴィニョンブラン||Sauvignon blanc (wine grape variety)
ソーヴィニヨン・ブラン||Sauvignon blanc (wine grape variety)
ソーヴィニョン・ブラン||Sauvignon blanc (wine grape variety)
ミュスカデル||Muscadelle (wine grape variety)
タナ||Tannat (wine grape variety)
タナット||Tannat (wine grape variety)
ＰＯＰ広告|ポップこうこく|point-of-purchase advertising
ポップ広告|ポップこうこく|point-of-purchase advertising
ピノブラン||Pinot blanc (wine grape variety)
ピノ・ブラン||Pinot blanc (wine grape variety)
ピノグリ||Pinot gris (wine grape variety)
ピノ・グリ||Pinot gris (wine grape variety)
アリゴテ||Aligoté (wine grape variety)
ソーヴィニヨングリ||Sauvignon gris (wine grape variety)
ソーヴィニョングリ||Sauvignon gris (wine grape variety)
ソーヴィニヨン・グリ||Sauvignon gris (wine grape variety)
ソーヴィニョン・グリ||Sauvignon gris (wine grape variety)
ピノムニエ||Pinot Meunier (wine grape variety)
ピノ・ムニエ||Pinot Meunier (wine grape variety)
ユニブラン||Ugni blanc (wine grape variety)
ユニ・ブラン||Ugni blanc (wine grape variety)
削除キー|さくじょキー|delete key; DEL key
コロンバール||Colombard (wine grape variety)
モーザック||Mauzac (wine grape variety)
唱法|しょうほう|singing technique; way of singing
シラーズ||Shiraz (wine grape variety)
グルナッシュ||Grenache (wine grape variety)
釈台|しゃくだい|low table used by speakers, professional storytellers, etc.; lectern
ムールヴェードル||Mourvèdre (wine grape variety)
ムールベードル||Mourvèdre (wine grape variety)
ヴィオニエ||Viogner (wine grape variety)
フォルブランシュ||Folle Blanche (wine grape variety)
フォル・ブランシュ||Folle Blanche (wine grape variety)
ジュランソン||Jurançon (wine grape variety)
ピノタージュ||Pinotage (wine grape variety)
シュナンブラン||Chenin blanc (wine grape variety)
シュナン・ブラン||Chenin blanc (wine grape variety)
ムロンドブルゴーニュ||Melon de Bourgogne (wine grape variety)
ムロン・ド・ブルゴーニュ||Melon de Bourgogne (wine grape variety)
車校|しゃこう|driving school
帯気音|たいきおん|aspirate; aspirated consonant
無気音|むきおん|unaspirated sound
追称|ついしょう|posthumous name
ボルドー||Bordeaux
ブルゴーニュ||Burgundy (wine); Bourgogne
プロダクトプレイスメント||product placement
プロダクトプレースメント||product placement
プロダクト・プレイスメント||product placement
プロダクト・プレースメント||product placement
廠舎|しょうしゃ|barracks; cantonment
廠舎|しょうしゃ|temporary lodging with roof but no walls (esp. for military exercises)
卦兆|かちょう|divination signs
甘言蜜語|かんげんみつご|honeyed words; flattery
味噌こし|みそこし|miso strainer
味噌漉し|みそこし|miso strainer
サザエに金平糖|サザエにこんぺいとう|two people arguing and not letting the other express their opinions
栄螺に金平糖|さざえにこんぺいとう|two people arguing and not letting the other express their opinions
どじょう汁に金鍔|どじょうじるにきんつば|two things that do not go well together; pairing kintsuba with loach soup
泥鰌汁に金鍔|どじょうじるにきんつば|two things that do not go well together; pairing kintsuba with loach soup
蜜語|みつご|sweet whispers of love; sweet nothings; lovers' whispers
痩せさらばえる|やせさらばえる|to be emaciated; to be nothing but skin and bones
痩せ曝える|やせさらばえる|to be emaciated; to be nothing but skin and bones
甜言蜜語|てんげんみつご|honeyed words; flattery
莫逆の交わり|ばくぎゃくのまじわり|getting along extremely well; maintaining a fond friendship
頭襟|ときん|black headgear worn by yamabushi
兜巾|ときん|black headgear worn by yamabushi
頭巾|ときん|black headgear worn by yamabushi
揖譲|ゆうじょう|bowing respectfully with one's hands clasped in front of one's chest
揖譲|ゆうじょう|abdication of an emperor to a successor (China)
瓦石|がせき|worthless thing; garbage; roof tile and stone
瓦石|がせき|brick
一虚一盈|いっきょいちえい|constantly changing phase and being highly unpredictable
虎豹|こひょう|tigers and leopards
虎豹|こひょう|daring person (animal, etc.); ferocious (person)
伝統ある|でんとうある|long-established; old-established; traditional
白駒の隙を過ぐるが如し|はっくのげきをすぐるがごとし|time flies; like watching a white horse run by through a gap in the wall (Zhuangzi)
疎か|おろか|not to mention ...; needless to say ...; not to speak of ...; not only ...
疎か|おろか|negligent; neglectful; careless; remiss
甥姪|おいめい|nephews and nieces
甥姪|せいてつ|nephews and nieces
諒恕|りょうじょ|consideration (for someone's circumstances); compassion; pardon; mercy
満盈|まんえい|being completely full
砥|と|whetstone; grindstone
魁星|かいせい|first star of the Big Dipper
魁星|かいせい|top applicant in the civil service examination (Imperial China)
忽せ|ゆるがせ|negligent; careless
忽せ|ゆるがせ|easygoing; relaxed
鉤形|かぎがた|hook shaped; bent at a right angle
鍵形|かぎがた|hook shaped; bent at a right angle
鈎形|かぎがた|hook shaped; bent at a right angle
禿髪|とくはつ|baldness; balding; bald head
笹藪|ささやぶ|thicket of bamboo grass
笹薮|ささやぶ|thicket of bamboo grass
孤掌鳴らし難し|こしょうならしがたし|one cannot live solely by oneself; one cannot accomplish anything solely by oneself; cannot clap with just one hand
親の欲目|おやのよくめ|parents' partiality for their children; parents overvaluing their children
親の欲目と他人の僻目|おやのよくめとたにんのひがめ|parents overvaluing their own children but looking down on others'
アリカンテブーシェ||Alicante Bouschet (wine grape variety)
アリカンテ・ブーシェ||Alicante Bouschet (wine grape variety)
アラモン||Aramon (wine grape variety)
オーセロワ||Auxerrois (wine grape variety)
ブールブラン||Bourboulenc (wine grape variety)
カラドック||Caladoc (wine grape variety)
カリニャン||Carignan (wine grape variety)
侵寇|しんこう|harmful military conquest; occupation of other countries
シャスラ||Chasselas (wine grape variety)
サンソー||Cinsaut (wine grape variety); Cinsault
クレレット||Clairette (wine grape variety)
クノワーズ||Counoise (wine grape variety)
クーノワーズ||Counoise (wine grape variety)
ゲヴュルツトラミネール||Gewürztraminer (wine grape variety); Gewurztraminer
ゲヴュルツトラミーナー||Gewürztraminer (wine grape variety); Gewurztraminer
忽せにする|ゆるがせにする|to be negligent; to neglect; to slight
垢衣|こうい|dirty clothes; grimy clothes
貨賂|かろ|bribe
侃直|かんちょく|firm and upright (character)
コートデュローヌ||Côtes du Rhône (wine)
コート・デュ・ローヌ||Côtes du Rhône (wine)
グルナッシュノワール||Grenache noir (wine grape variety)
グルナッシュ・ノワール||Grenache noir (wine grape variety)
グルナッシュブラン||Grenache blanc (wine grape variety)
グルナッシュ・ブラン||Grenache blanc (wine grape variety)
グルナッシュグリ||Grenache gris (wine grape variety)
グルナッシュ・グリ||Grenache gris (wine grape variety)
ガルナッチャ||Garnacha (wine grape variety)
取水塔|しゅすいとう|intake tower; outlet tower
星列|せいれつ|asterism
星列|せいれつ|lining up (like a row of stars)
門前雀羅を張る|もんぜんじゃくらをはる|(a house) looking deserted with few visitors
巧詐は拙誠に如かず|こうさはせっせいにしかず|it is better to do things shoddily yet sincerely rather than to cleverly deceive
ヴァルディギエ||Valdiguié (wine grape variety)
グロマンサン||Gros Manseng (wine grape variety)
グロ・マンサン||Gros Manseng (wine grape variety)
プティマンサン||Petit Manseng (wine grape variety)
プティ・マンサン||Petit Manseng (wine grape variety)
ジャケール||Jacquère (wine grape variety)
マカベオ||Macabeo (wine grape variety)
マカベウ||Macabeu (wine grape variety)
マルサンヌ||Marsanne (wine grape variety)
マルスラン||Marselan (wine grape variety)
マルセラン||Marselan (wine grape variety)
電気磁気学|でんきじきがく|electromagnetism (usu. in engineering)
ネグレット||Négrette (wine grape variety)
ニエルッキオ||Nielluccio (wine grape variety)
ニエルキオ||Nielluccio (wine grape variety)
スキアカレロ||Sciacarello (wine grape variety)
ヴェルメンティーノ||Vermentino (wine grape variety)
ピクプール||Piquepoul (wine grape variety); Picpoul; Picapoll
ピクプールノワール||Piquepoul noir (wine grape variety)
ピクプール・ノワール||Piquepoul noir (wine grape variety)
ピクプールブラン||Piquepoul blanc (wine grape variety)
ピクプール・ブラン||Piquepoul blanc (wine grape variety)
透漆|すきうるし|clear lacquer
透き漆|すきうるし|clear lacquer
朱漆|しゅうるし|vermilion lacquer (made by mixing vermilion into clear lacquer)
苫屋|とまや|rush-thatched house
墾く|ひらく|to cultivate (land); to clear (land)
陰になり日向になり|かげになりひなたになり|openly and secretly; helping in all ways
陰になりひなたになり|かげになりひなたになり|openly and secretly; helping in all ways
蓑になり笠になり|みのになりかさになり|helping and protecting in all ways; acting as a raincoat (protecting from rain) and acting as a hat (protecting from sun)
アスタナ||Astana (Kazakhstan)
オスロ||Oslo (Norway)
信号弾|しんごうだん|pyrotechnic signal; signal flare
管窺|かんき|narrow insight; narrow view
管を以て天を窺う|くだをもっててんをうかがう|to make a personal judgment on a problem with little insight; to look at the sky through a tube (Zhuangzi)
亡羊補牢|ぼうようほろう|locking the barn door after the horse has bolted; doing something too late; mending the pen after the sheep are lost
知らぬ仏より馴染みの鬼|しらぬほとけよりなじみのおに|better the devil you know than the devil you don't know; better the ogre you know than the Buddha you don't
知らぬ神より馴染みの鬼|しらぬかみよりなじみのおに|better the devil you know than the devil you don't know; better the ogre you know than the god you don't
良禽は木を択んで棲む|りょうきんはきをえらんですむ|a wise retainer chooses a great lord to serve; a wise bird chooses a good tree in which to roost
化政文化|かせいぶんか|merchant class culture that flourished in Edo during the Bunka-Bunsei period
釜中の魚|ふちゅうのうお|fish in a pot about to be boiled; person who is blissfully unaware of deadly danger
チョン公|チョンこう|Korean
ちょんこう||Korean
チョンコー||Korean
チョンコ||Korean
プルサール||Poulsard (wine grape variety)
ルーサンヌ||Roussanne (wine grape variety)
サヴァニャン||Savagnin (wine grape variety)
シルヴァーナー||Sylvaner (wine grape variety); Silvaner
ジルヴァーナー||Sylvaner (wine grape variety); Silvaner
シルバーナー||Sylvaner (wine grape variety); Silvaner
シルヴァネール||Sylvaner (wine grape variety); Silvaner
シルバネール||Sylvaner (wine grape variety); Silvaner
テレブラン||Terret blanc (wine grape variety)
テレ・ブラン||Terret blanc (wine grape variety)
テレノワール||Terret noir (wine grape variety)
テレ・ノワール||Terret noir (wine grape variety)
テレグリ||Terret gris (wine grape variety)
テレ・グリ||Terret gris (wine grape variety)
県大会|けんたいかい|prefectural tournament
求知心|きゅうちしん|heart seeking knowledge
拝跪|はいき|kneeling down (to pray); going down on one's knees
バーガンディー||burgundy (red)
バーガンディー||Burgundy (wine); Bourgogne
独自色|どくじしょく|uniqueness; individuality
トゥルソー||Trousseau (wine grape variety)
トルソー||Trousseau (wine grape variety)
サスペンデッド||suspended
閣外協力|かくがいきょうりょく|cooperation with the government from outside the cabinet
乃公出でずんば|だいこういでずんば|what will happen to everyone else if I am not the one who goes? (expression of confidence from someone going out into the world)
匹夫も志を奪うべからず|ひっぷもこころざしをうばうべからず|one cannot shake the will of even the lowliest man; a person's will should be respected; even a menial deserves his convictions
鴻毛|こうもう|something extremely light
鴻毛|こうもう|feather of a large bird
来住|らいじゅう|coming to live (at a place)
鶯遷|おうせん|warbler flying from a valley to a tree
鶯遷|おうせん|finding success in life
鶯遷|おうせん|passing the palace examination
鶯谷|おうこく|warbler being in a valley
鶯谷|おうこく|valley in which warblers live
鶯谷|おうこく|remaining obscure and unsuccessful
魯魚章草|ろぎょしょうそう|miswriting a word; using the wrong kanji to write a word
抗論|こうろん|refutation; repudiation; objection
井蛙は以って海を語る可からず|せいあはもってうみをかたるべからず|a narrow-minded person cannot understand the ways of the world; a frog in the well cannot understand the ocean even if it is explained to it
美味しそう|おいしそう|delicious-looking; tasty-looking
美味しそう|おいしそう|hot; sexy; desirable
靴新しと雖も首に加えず|くつあたらしといえどもくびにくわえず|there must be a clear distinction between the upper and lower classes; even new shoes must not be worn on the head
沓新しと雖も首に加えず|くつあたらしといえどもくびにくわえず|there must be a clear distinction between the upper and lower classes; even new shoes must not be worn on the head
鎮咳|ちんがい|cough suppression
鎮咳|ちんがい|antitussive
鎮咳剤|ちんがいざい|cough suppressant; antitussive drug; cough medicine
鎮咳薬|ちんがいやく|cough suppressant; antitussive drug; cough medicine
集く|すだく|to chirp (of a swarm of insects); to sing
集く|すだく|to gather; to swarm
孟母断機の教え|もうぼだんきのおしえ|one should not leave things unfinished; when a young Mencius returned home during the middle of school, his mother cut off the cloth she had been weaving on the loom to admonish him for stopping his studies midway
昼夜を問わず|ちゅうやをとわず|day and night; around the clock
生まれたままの姿|うまれたままのすがた|completely naked; in one's birthday suit
生まれたままのすがた|うまれたままのすがた|completely naked; in one's birthday suit
うまれたままの姿|うまれたままのすがた|completely naked; in one's birthday suit
事後審|じごしん|judicial review by a higher court without introducing new evidence
断機|だんき|cutting the threads on a loom
節日|せちにち|seasonal festival
節日|せつじつ|seasonal festival
岨道|そばみち|steep mountain road; dangerous mountain path
岨道|そわみち|steep mountain road; dangerous mountain path
岨路|そばみち|steep mountain road; dangerous mountain path
岨路|そわみち|steep mountain road; dangerous mountain path
将|はた|or; otherwise
将|はた|furthermore; also
将|はた|perhaps; by some chance; possibly
将|はた|that being said; be that as it may
将|はた|however; but
将|はた|not to mention; needless to say
将|はた|as expected; sure enough
将|はた|really; at all
当|はた|or; otherwise
当|はた|furthermore; also
当|はた|perhaps; by some chance; possibly
当|はた|that being said; be that as it may
当|はた|however; but
当|はた|not to mention; needless to say
当|はた|as expected; sure enough
当|はた|really; at all
会稽の恥|かいけいのはじ|humiliation of defeat in battle; past humiliation by others; shame of an unendurable disgrace
会稽の恥を雪ぐ|かいけいのはじをすすぐ|to avenge a defeat; to regain one's honor
会稽の恥をすすぐ|かいけいのはじをすすぐ|to avenge a defeat; to regain one's honor
伸子|しんし|temple (in a loom); tenter
籡|しんし|temple (in a loom); tenter
喀出|かくしゅつ|expectoration; spitting
シュペートブルグンダー||Spätburgunder (wine grape variety)
シュペート・ブルグンダー||Spätburgunder (wine grape variety)
修身斉家治国平天下|しゅうしんせいかちこくへいてんか|those who wish to rule the land must first cultivate their own characters, then manage their families, then govern their states; only then can they bring peace to the land (a mantra of Confucianism)
挨拶は時の氏神|あいさつはときのうじがみ|those arguing should be thankful for a mediator's intervention and follow the mediator's advice
氷炭相容れず|ひょうたんあいいれず|having completely different natures and being incompatible with each other; like oil and water; ice and (charcoal) fire cannot coexist
鵜呑みにする|うのみにする|to swallow (e.g. a story); to accept without questioning
鵜呑みにする|うのみにする|to swallow (food) whole; to gobble up; to gulp down
登録抹消|とうろくまっしょう|deregistration; cancellation of registration
利鎌|とがま|sharp sickle
利鎌|とかま|sharp sickle
戎馬|じゅうば|warhorse
火蟻|ひあり|red imported fire ant (Solenopsis invicta)
ヒアリ||red imported fire ant (Solenopsis invicta)
戦馬|せんば|warhorse; military horse
相変態|そうへんたい|phase transformation; phrase transition
藪沢|そうたく|wetland with abundant vegetation
藪沢|そうたく|place where things are gathered
薮沢|そうたく|wetland with abundant vegetation
薮沢|そうたく|place where things are gathered
拭浄|しょくじょう|wiping and purifying; wiping and cleansing
纂述|さんじゅつ|gathering and writing up material
嘉肴ありと雖も食らわずんばその旨きを知らず|かこうありといえどもくらわずんばそのうまきをしらず|one cannot understand even a holy man's teachings without study; one cannot know the abilities of a great man without putting him to use; one cannot know the delicious taste of fine food without eating it
鶏群の一鶴|けいぐんのいっかく|a swan among ducklings; a diamond among stones; a great figure among the common run of men
河童の寒稽古|かっぱのかんげいこ|something that looks difficult but actually isn't; swimming in a cold lake during mid-winter seems difficult, but it's nothing to a kappa
軍事学|ぐんじがく|military science; military studies
ブラウブルグンダー||Blauburgunder (wine grape variety)
ブラウフレンキッシュ||Blaufränkisch (wine grape variety)
ブラウアーポルトギーザー||Blauer Portugieser (wine grape variety)
ブラウアーポルチュギーザー||Blauer Portugieser (wine grape variety)
ブラウアー・ポルトギーザー||Blauer Portugieser (wine grape variety)
ブラウアー・ポルチュギーザー||Blauer Portugieser (wine grape variety)
ドミナ||Domina (wine grape variety)
ドルンフェルダー||Dornfelder (wine grape variety)
バフース||Bacchus (wine grape variety)
バッカス||Bacchus (wine grape variety)
エルブリング||Elbling (wine grape variety)
前方宣言|ぜんぽうせんげん|forward declaration
生え出る|はえでる|to sprout; to spring up; to come out
はえ出る|はえでる|to sprout; to spring up; to come out
生えでる|はえでる|to sprout; to spring up; to come out
縦断面|じゅうだんめん|longitudinal section
もし良かったら|もしよかったら|if you don't mind; if you like; if you feel up for it; if you're interested
妖姫|ようき|ghostly, beautiful woman
妖姫|ようき|ghost of a beautiful woman
鴛鴦の契り|えんおうのちぎり|having a happy and harmonious relationship (of a husband and wife)
欲の熊鷹股裂くる|よくのくまたかまたさくる|avarice brings doom upon oneself; if a hawk-eagle tries to catch two boars at once, the boars will try to run in opposite directions, splitting the hawk-eagle into two and killing it
グリューナーフェルトリーナー||Grüner Veltliner (wine grape variety)
グリューナーフェルトリナー||Grüner Veltliner (wine grape variety)
グリューナー・フェルトリーナー||Grüner Veltliner (wine grape variety)
グリューナー・フェルトリナー||Grüner Veltliner (wine grape variety)
鳶飛魚躍|えんぴぎょやく|all of creation following their original natures, living and enjoying themselves freely; the kites fly and the fish leap
鳶飛魚躍|えんぴぎょやく|Heaven's will that all of creation shall follow their original natures and live freely
鳶飛魚躍|えんぴぎょやく|as a ruler's benevolence spreads, the people will find their places in the land based on their abilities
グラウブルグンダー||Grauburgunder (wine grape variety)
グラウアーブルグンダー||Grauer Burgunder (wine grape variety)
グラウアー・ブルグンダー||Grauer Burgunder (wine grape variety)
グートエーデル||Gutedel (wine grape variety)
グーテデル||Gutedel (wine grape variety)
ヘロルドレーベ||Heroldrebe (wine grape variety)
ヘロルトレーベ||Heroldrebe (wine grape variety)
ケルナー||Kerner (wine grape variety)
ふつくしい||beautiful
琺瑯質|ほうろうしつ|(tooth) enamel
ほうろう質|ほうろうしつ|(tooth) enamel
雨露をしのぐ|あめつゆをしのぐ|to protect against the elements; to shelter oneself from the weather
雨露を凌ぐ|あめつゆをしのぐ|to protect against the elements; to shelter oneself from the weather
粘り勝ち|ねばりがち|hard-fought win; winning through perseverance
一途をたどる|いっとをたどる|to continue (going along some trend)
一途を辿る|いっとをたどる|to continue (going along some trend)
指サック|ゆびサック|finger stall; fingerstall; finger cot; rubber finger tip; rubber thimble; thimblette
声符|せいふ|verbal command (in dog training)
声符|せいふ|sound part of a semasio-phonetic kanji
視符|しふ|hand signal; visual signal (in dog training)
レンベルガー||Lemberger (wine grape variety)
ミュラートゥルガウ||Müller-Thurgau (wine grape variety)
ミューラートゥルガウ||Müller-Thurgau (wine grape variety)
ミュラー・トゥルガウ||Müller-Thurgau (wine grape variety)
ミューラー・トゥルガウ||Müller-Thurgau (wine grape variety)
ミュラーレーベ||Müllerrebe (wine grape variety)
ミューラーレーベ||Müllerrebe (wine grape variety)
ノイブルガー||Neuburger (wine grape variety)
オルテガ||Ortega (wine grape variety)
ポルトギーザー||Portugieser (wine grape variety); Blauer Portugieser
ポルチュギーザー||Portugieser (wine grape variety); Blauer Portugieser
添え板|そえいた|doubling plate (carpentry); fishplate (railways); attached board
添板|そえいた|doubling plate (carpentry); fishplate (railways); attached board
ルーレンダー||Ruländer (wine grape variety)
紅軍|こうぐん|Red Army; Chinese Workers' and Peasants' Red Army
洋務運動|ようむうんどう|Self-Strengthening Movement; Westernization Movement; political reform movement in China during the late Qing dynasty
槓ドラ|カンドラ|dora tile revealed when a player declares a kong
裏ドラ|うらドラ|hidden dora tile available when a player wins by riichi
八路軍|はちろぐん|Eighth Route Army; 18th Army Group of the National Revolutionary Army of the Republic of China
国民革命軍|こくみんかくめいぐん|National Revolutionary Army (Republic of China, 1925-1947)
心裡留保|しんりりゅうほ|mental reservation; making a false declaration of intent
錯語|さくご|paraphasia
ショイレーベ||Scheurebe (wine grape variety)
シュヴァルツリースリング||Schwarzriesling (wine grape variety)
スキアーヴァ||Schiava (wine grape variety)
トロリンガー||Trollinger (wine grape variety)
ヴェルシュリースリング||Welschriesling (wine grape variety)
ウェルシュリースリング||Welschriesling (wine grape variety)
マタロ||Mataro (wine grape variety)
ルビーカベルネ||Ruby Cabernet (wine grape variety)
ルビー・カベルネ||Ruby Cabernet (wine grape variety)
ノンレム睡眠|ノンレムすいみん|non-REM sleep
ヴァイスブルグンダー||Weissburgunder (wine grape variety)
ヴァイサーブルグンダー||Weisser Burgunder (wine grape variety)
ヴァイサー・ブルグンダー||Weisser Burgunder (wine grape variety)
ツヴァイゲルト||Zweigelt (wine grape variety)
ツヴァイゲルトレーベ||Zweigeltrebe (wine grape variety)
サンローラン||Saint Laurent (wine grape variety); Sankt Laurent; St. Laurent
サン・ローラン||Saint Laurent (wine grape variety); Sankt Laurent; St. Laurent
下令|かれい|giving an order
盲聾|もうろう|deafblindness; deaf-blind person
盲ろう|もうろう|deafblindness; deaf-blind person
盲聾者|もうろうしゃ|deaf-blind person
盲ろう者|もうろうしゃ|deaf-blind person
心の欲する所に従えども矩を踰えず|こころのほっするところにしたがえどものりをこえず|to be able to follow the desires of one's own heart without transgressing what is right (from the Analects of Confucius)
臆度|おくたく|guessing; speculation; supposition; hypothesis
誘く|おびく|to lure; to entice
一顧傾城|いっこけいせい|woman so glamorous as to bring ruin to a country (castle) as its king (lord) is captivated by her beauty; femme fatale
洞ヶ峠を決め込む|ほらがとうげをきめこむ|to wait for a good opportunity; to come down on the right side of the fence; to see which way the cat jumps; to wait and see at Horagatoge
洞が峠を決め込む|ほらがとうげをきめこむ|to wait for a good opportunity; to come down on the right side of the fence; to see which way the cat jumps; to wait and see at Horagatoge
洞ヶ峠をきめこむ|ほらがとうげをきめこむ|to wait for a good opportunity; to come down on the right side of the fence; to see which way the cat jumps; to wait and see at Horagatoge
洞が峠をきめこむ|ほらがとうげをきめこむ|to wait for a good opportunity; to come down on the right side of the fence; to see which way the cat jumps; to wait and see at Horagatoge
金箔が剥げる|きんぱくがはげる|to reveal one's true colors
身体髪膚これを父母に受くあえて毀傷せざるは孝の始めなり|しんたいはっぷこれをふぼにうくあえてきしょうせざるはこうのはじめなり|filial piety begins with not harming one's own body (as one's entire body was given by one's parents) (from The Classic of Filial Piety)
身体髪膚これを父母に受くあえて毀傷せざるは孝の始なり|しんたいはっぷこれをふぼにうくあえてきしょうせざるはこうのはじめなり|filial piety begins with not harming one's own body (as one's entire body was given by one's parents) (from The Classic of Filial Piety)
薬袋|やくたい|prescription bag; pharmacy bag
薬袋|やくたい|small bottle for carrying gunpowder
セルフプレー||playing golf without a caddy
セルフ・プレー||playing golf without a caddy
マッシブ||massive
爾汝の交わり|じじょのまじわり|close acquaintance; relationship where two people are close enough to use familiar language
芝蘭|しらん|reishi mushroom and thoroughwort; fragrant plants
芝蘭|しらん|talented; virtuous
反故紙|ほごがみ|wastepaper; scrap paper
反古紙|ほごがみ|wastepaper; scrap paper
手垢のついた|てあかのついた|thumb-marked; well-used; well-thumbed; well-handled
手垢のついた|てあかのついた|worn-out (e.g. joke); stale; hackneyed
手垢の付いた|てあかのついた|thumb-marked; well-used; well-thumbed; well-handled
手垢の付いた|てあかのついた|worn-out (e.g. joke); stale; hackneyed
手あかのついた|てあかのついた|thumb-marked; well-used; well-thumbed; well-handled
手あかのついた|てあかのついた|worn-out (e.g. joke); stale; hackneyed
手あかの付いた|てあかのついた|thumb-marked; well-used; well-thumbed; well-handled
手あかの付いた|てあかのついた|worn-out (e.g. joke); stale; hackneyed
サンクトラウレント||Sankt Laurent (wine grape variety); Saint Laurent; St. Laurent
サンクト・ラウレント||Sankt Laurent (wine grape variety); Saint Laurent; St. Laurent
シャトーヌフデュパプ||Châteauneuf-du-Pape (wine)
シャトーヌフ・デュ・パプ||Châteauneuf-du-Pape (wine)
肯んじる|がえんじる|to consent; to allow; to accept; to agree
肯じる|がえんじる|to consent; to allow; to accept; to agree
屋烏の愛|おくうのあい|true love; deep love; love for someone so deep that it can reach a crow perched on that person's roof
破鏡再び照らさず|はきょうふたたびてらさず|a broken relationship can never be repaired; a divorced couple are never reconciled; a broken mirror will never shine again
購う|あがなう|to buy; to pay for
フィアーノ||Fiano (wine grape variety)
ガルガネーガ||Garganega (wine grape variety)
ガルガーネガ||Garganega (wine grape variety)
ガルガネガ||Garganega (wine grape variety)
グレーラ||Glera (wine grape variety)
グレラ||Glera (wine grape variety)
プロセッコ||Prosecco (wine)
プロセッコ||Prosecco (wine grape variety)
グリッロ||Grillo (wine grape variety)
どじょう汁|どじょうじる|loach soup
ドジョウ汁|ドジョウじる|loach soup
泥鰌汁|どじょうじる|loach soup
ピノビアンコ||Pinot Bianco (wine grape variety)
ピノ・ビアンコ||Pinot Bianco (wine grape variety)
ピノグリージョ||Pinot Grigio (wine grape variety)
ピノ・グリージョ||Pinot Grigio (wine grape variety)
ピノネロ||Pinot Nero (wine grape variety)
ピノネーロ||Pinot Nero (wine grape variety)
ピノ・ネロ||Pinot Nero (wine grape variety)
ピノ・ネーロ||Pinot Nero (wine grape variety)
識別信号|しきべつしんごう|identifying signal; recognition signal; (radio) call sign
信号符字|しんごうふじ|call sign (esp. maritime); distinctive letters
管海官庁|かんかいかんちょう|maritime authority; marine office
音響信号|おんきょうしんごう|acoustic signal; audible signal; audio signal
発光信号|はっこうしんごう|flash signal (e.g. between ships); flashing caution signal; accident warning signal
船名録|せんめいろく|register book (for a ship)
信号書|しんごうしょ|signal code book
列車電話|れっしゃでんわ|train telephone; railway radiotelephone
鉄道電話|てつどうでんわ|railway telephone
生活排水|せいかつはいすい|domestic wastewater; household effluent
二遊間|にゆうかん|between short and second; middle
官地|かんち|government land; public land
カードケース||card case
カード・ケース||card case
ブラフ||bluff
シングルハンダー||single-hander (yachting); single-handed sailing
落下点|らっかてん|point of fall
サイドアーム||sidearm; side arm
紙製|かみせい|(something) made from paper
紙製|しせい|(something) made from paper
アウトサイダーアート||outsider art
アウトサイダー・アート||outsider art
アールブリュット||art brut; outsider art
アールブリュト||art brut; outsider art
アール・ブリュット||art brut; outsider art
アール・ブリュト||art brut; outsider art
マルヴァジーア||Malvasia (wine grape variety)
マルヴァジア||Malvasia (wine grape variety)
レフォスコ||Refosco (wine grape variety)
レフォシュク||Refošk (wine grape variety)
誰にともなく|だれにともなく|to no one in particular
誰にとも無く|だれにともなく|to no one in particular
翠微|すいび|approx. 80% of the way up a mountainside
翠微|すいび|view of a light green mountain; mountain that appears green from afar
壺中|こちゅう|inside a jar
壺中|こちゅう|coward; timid person
壷中|こちゅう|inside a jar
壷中|こちゅう|coward; timid person
色水|いろみず|colored water
移入種|いにゅうしゅ|introduced species; non-native species; alien species
侵入種|しんにゅうしゅ|invasive species
聾盲|ろうもう|deafblindness; deaf-blind person
ろう盲|ろうもう|deafblindness; deaf-blind person
壺中の天地|こちゅうのてんち|another world; enchanted land; joy from drinking and forgetting about the workaday world
壷中の天地|こちゅうのてんち|another world; enchanted land; joy from drinking and forgetting about the workaday world
血を分ける|ちをわける|to be related by blood
ダブスタ||double standard
ポリコレ||political correctness
肇造|ちょうぞう|establishment; creation (e.g. of a country); foundation
凹き所に水溜まる|くぼきところにみずたまる|when the right conditions are fulfilled, things will turn out well on their own; a sunken place will collect water
凹き所に水溜まる|くぼきところにみずたまる|someone in bad circumstances will continue to accumulate difficulties
計器着陸装置|けいきちゃくりくそうち|instrument landing system; ILS
スパゲティナポリタン||spaghetti Napolitana; Italian spaghetti dish made with a tomato sauce
スパゲッティナポリタン||spaghetti Napolitana; Italian spaghetti dish made with a tomato sauce
スパゲティーナポリタン||spaghetti Napolitana; Italian spaghetti dish made with a tomato sauce
スパゲッティーナポリタン||spaghetti Napolitana; Italian spaghetti dish made with a tomato sauce
スパゲティ・ナポリタン||spaghetti Napolitana; Italian spaghetti dish made with a tomato sauce
スパゲッティ・ナポリタン||spaghetti Napolitana; Italian spaghetti dish made with a tomato sauce
スパゲティー・ナポリタン||spaghetti Napolitana; Italian spaghetti dish made with a tomato sauce
スパゲッティー・ナポリタン||spaghetti Napolitana; Italian spaghetti dish made with a tomato sauce
使役犬|しえきけん|working dog
狩猟犬|しゅりょうけん|hunting dog
白煮|しらに|white vegetables or fish simmered without soy sauce
緩か|ゆるか|loose; slack
緩か|ゆるか|gentle; easy; slow
緩か|ゆるか|lenient; liberal; lax
入学祝い|にゅうがくいわい|congratulations on entering a school; gift to someone entering a school
入学祝|にゅうがくいわい|congratulations on entering a school; gift to someone entering a school
スパゲティボロネーゼ||spaghetti Bolognese; spaghetti with meat sauce
スパゲッティボロネーゼ||spaghetti Bolognese; spaghetti with meat sauce
スパゲティーボロネーゼ||spaghetti Bolognese; spaghetti with meat sauce
スパゲッティーボロネーゼ||spaghetti Bolognese; spaghetti with meat sauce
スパゲティ・ボロネーゼ||spaghetti Bolognese; spaghetti with meat sauce
スパゲッティ・ボロネーゼ||spaghetti Bolognese; spaghetti with meat sauce
スパゲティー・ボロネーゼ||spaghetti Bolognese; spaghetti with meat sauce
スパゲッティー・ボロネーゼ||spaghetti Bolognese; spaghetti with meat sauce
言語政策|げんごせいさく|language policy
逆位|ぎゃくい|(chromosomal) inversion
内破音|ないはおん|unreleased stop; applosive
入破音|にゅうはおん|implosive consonant
別掲|べっけい|displaying separately; referencing elsewhere
丸わかり|まるわかり|understanding completely; understanding all there is to know
丸分かり|まるわかり|understanding completely; understanding all there is to know
丸分り|まるわかり|understanding completely; understanding all there is to know
モナストレル||Monastrell (wine grape variety)
パレリャーダ||Parellada (wine grape variety)
ペドロヒメネス||Pedro Ximénez (wine grape variety)
ペドロ・ヒメネス||Pedro Ximénez (wine grape variety)
ガリシア語|ガリシアご|Galician (language)
廃課金|はいかきん|spending unreasonably on in-game purchases
超正常|ちょうせいじょう|hypernormal; supranormal; supernormal
ボバル||Bobal (wine grape variety)
メンシア||Mencia (wine grape variety)
チャレッロ||Xarello (wine grape variety); Xarel-lo
ペリキータ||Periquita (wine grape variety)
カステラン||Castelão (wine grape variety)
ロウレイラ||Loureira (wine grape variety); Loureiro
ローレイラ||Loureira (wine grape variety); Loureiro
ロウレイロ||Loureira (wine grape variety); Loureiro
ローレイロ||Loureira (wine grape variety); Loureiro
孤児著作物|こじちょさくぶつ|orphan works
孤児作品|こじさくひん|orphan works
心に掛ける|こころにかける|to take to heart; to keep in mind; to bear in mind
心に任せる|こころにまかせる|to do as one wishes; to suit one's convenience
心に任せる|こころにまかせる|for something to happen as one expects
心にまかせる|こころにまかせる|to do as one wishes; to suit one's convenience
心にまかせる|こころにまかせる|for something to happen as one expects
お含みおきください|おふくみおきください|please understand that...; please bear in mind that ...
お含みおき下さい|おふくみおきください|please understand that...; please bear in mind that ...
御含みおきください|おふくみおきください|please understand that...; please bear in mind that ...
御含みおき下さい|おふくみおきください|please understand that...; please bear in mind that ...
お含み置きください|おふくみおきください|please understand that...; please bear in mind that ...
お含み置き下さい|おふくみおきください|please understand that...; please bear in mind that ...
御含み置きください|おふくみおきください|please understand that...; please bear in mind that ...
御含み置き下さい|おふくみおきください|please understand that...; please bear in mind that ...
契約条件|けいやくじょうけん|conditions of a contract; terms of a contract
含み置く|ふくみおく|to understand; to keep in mind
含みおく|ふくみおく|to understand; to keep in mind
汎用性|はんようせい|versatility; multiplicity of use
フルミント||Furmint (wine grape variety)
ケークフランコシュ||Kékfrankos (wine grape variety)
ケクフランコシュ||Kékfrankos (wine grape variety)
ケコポルト||Kékoportó (wine grape variety)
クシノマヴロ||Xinomavro (wine grape variety); Xynomavro
アギヨルギティコ||Agiorgitiko (wine grape variety)
アギォルギティコ||Agiorgitiko (wine grape variety)
ルカツィテリ||Rkatsiteli (wine grape variety)
サペラヴィ||Saperavi (wine grape variety)
グランピング||glamping
投法|とうほう|way of throwing (esp. in baseball); throwing technique; pitching technique
両|りゃん|two
リャン||two
含み綿|ふくみわた|wad of cotton (esp. used in dentistry)
ユニバーサルシリアルバス||universal serial bus; USB
ユニバーサル・シリアル・バス||universal serial bus; USB
文武不岐|ぶんぶふき|scholarship and swordsmanship are one and the same; the literary and the military are the same path
郷鎮|ごうちん|township and village enterprises (in China); TVE
ホームソーイング||sewing done at home; home sewing
ホーム・ソーイング||sewing done at home; home sewing
略表|りゃくひょう|simplified list; summary list
再生毛|さいせいもう|recycled wool; reclaimed wool
紡毛糸|ぼうもうし|woolen yarn; woollen yarn; knitting wool
玉羅紗|たまらしゃ|type of woolen fabric, esp. used for overcoats
玉ラシャ|たまラシャ|type of woolen fabric, esp. used for overcoats
繊毛運動|せんもううんどう|ciliary movement
インフレ連動債|インフレれんどうさい|inflation-indexed bonds; inflation-linked bonds
ボテ腹|ボテばら|belly of a pregnant woman
掻き|かき|stroke (swimming); arm stroke
掻き|かき|adds strength or emphasis to verbs
搔き|かき|stroke (swimming); arm stroke
搔き|かき|adds strength or emphasis to verbs
かっ||adds strength or emphasis to verbs
かッ||adds strength or emphasis to verbs
ハリセン||paper fan used in slapstick comedy
変ニ長調|へんニちょうちょう|D flat major
嬰ハ短調|えいハたんちょう|C sharp minor
ぎりぎり||grinding (sound); grating; gnashing
ぎりぎり||forcefully; strongly; with effort; (binding) tightly
ギリギリ||grinding (sound); grating; gnashing
ギリギリ||forcefully; strongly; with effort; (binding) tightly
スカラー場|スカラーば|scalar field
クラブケーキ||crab cake
クラブ・ケーキ||crab cake
その人|そのひと|the person in question
その人|そのひと|prominent figure; distinguished person
その人|そのひと|that person
其の人|そのひと|the person in question
其の人|そのひと|prominent figure; distinguished person
其の人|そのひと|that person
低酸素症|ていさんそしょう|hypoxia
アドリアマイシン||Adriamycin
消防自動車|しょうぼうじどうしゃ|fire engine; fire truck
緊急自動車|きんきゅうじどうしゃ|emergency vehicle
救急自動車|きゅうきゅうじどうしゃ|ambulance
ドクターカー||ambulance with a doctor onboard
ドクター・カー||ambulance with a doctor onboard
災害医療|さいがいいりょう|disaster medicine
救急隊|きゅうきゅうたい|ambulance crew; ambulance squad; rescue squad
聖画像|せいがぞう|icon; religious picture; sacred image
霊きゅう自動車|れいきゅうじどうしゃ|hearse
霊柩自動車|れいきゅうじどうしゃ|hearse
８ナンバー|はちナンバー|special licence plate beginning with 8 used by police, ambulance, etc. vehicles
８ナンバー|はちナンバー|special use vehicle (e.g. police car, ambulance, sprinkler truck, etc.)
塵芥車|じんかいしゃ|garbage truck; dustcart
アンビュランス||ambulance
防衛軍|ぼうえいぐん|defence forces; defence corps
サボリ癖|サボリぐせ|habit of putting things off; truancy habit
さぼり癖|さぼりぐせ|habit of putting things off; truancy habit
コードブルー||code blue
コード・ブルー||code blue
カメオ出演|カメオしゅつえん|cameo performance; cameo appearance
デルマドローム||dermadrome
ハンドスピナー||fidget spinner
ハンド・スピナー||fidget spinner
背広組|せびろくみ|civil servants; bureaucrat
斗酒なお辞せず|としゅなおじせず|being ready to drink sake by the keg; drinking like a fish
インフルエンサー||influencer (e.g. on social media)
影響者|えいきょうしゃ|influencer
蒸し煮|むしに|simmering after steaming
蒸し煮|むしに|simmering (in a small amount of broth); smothering; estouffade
蒸煮|むしに|simmering after steaming
蒸煮|むしに|simmering (in a small amount of broth); smothering; estouffade
トーカブル||hot topic; something on everyone's lips
おきて破り|おきてやぶり|against the rules; breaking etiquette; illegal
掟破り|おきてやぶり|against the rules; breaking etiquette; illegal
非会員|ひかいいん|non-member
歌い回し|うたいまわし|manner of singing
葡語|ポご|Portuguese (language)
ポ語|ポご|Portuguese (language)
リテーナー||retainer
リテナー||retainer
引火源|いんかげん|ignition source
タップ操作|タップそうさ|touch controls
諸物|しょぶつ|various things
諸物|しょぶつ|fetish
庶物|しょぶつ|various things
庶物|しょぶつ|fetish
ニブル||nibble; nybble; nyble; half-byte; tetrade
二気|にき|two forces of yin and yang
セルシン||selsyn; synchro; self-synchronizing motor
双葉鈴木竜|ふたばすずきりゅう|Futabasaurus suzukii (species of plesiosaur)
フタバスズキリュウ||Futabasaurus suzukii (species of plesiosaur)
ネズミ返し|ネズミがえし|rat guard; disk of wood on storehouse pillars, ropes, etc.
ねずみ返し|ねずみがえし|rat guard; disk of wood on storehouse pillars, ropes, etc.
鼠返し|ねずみがえし|rat guard; disk of wood on storehouse pillars, ropes, etc.
鼠がえし|ねずみがえし|rat guard; disk of wood on storehouse pillars, ropes, etc.
スタッフロール||staff roll; list of staff
スタッフ・ロール||staff roll; list of staff
フォスフォラス||phosphorus (P)
素手で|すでで|empty-handed; barehanded; unarmed
そっくり其の儘|そっくりそのまま|exactly the same; exactly as is; without any change
缶ペンケース|かんペンケース|metal pencil box
カンペンケース||metal pencil box
玉浮き|たまうき|bubble float (angling); bobber
玉ウキ|たまウキ|bubble float (angling); bobber
玉うき|たまうき|bubble float (angling); bobber
玉浮|たまうき|bubble float (angling); bobber
ペンシルケース||pencil case
ペンシル・ケース||pencil case
ペンケース||pen case
ペン・ケース||pen case
デスクワゴン||desk pedestal
デスク・ワゴン||desk pedestal
性懲りもない|しょうこりもない|incorrigible; dogged
性懲りも無い|しょうこりもない|incorrigible; dogged
ナノ粒子|ナノりゅうし|nanoparticle
ナノテク||nanotech; nanotechnology
兄弟会社|きょうだいがいしゃ|affiliated company; sister company
インボランタリーアップグレード||involuntary upgrade; operational upgrade; free upgrade to business or first class on an overbooked flight
インボランタリー・アップグレード||involuntary upgrade; operational upgrade; free upgrade to business or first class on an overbooked flight
微レ存|びレぞん|existence (of a minute possibility)
微レ存|びレそん|existence (of a minute possibility)
鉄道警察|てつどうけいさつ|railway police; railroad police
鉄道警察隊|てつどうけいさつたい|railway police (Japan); Railway Police Force
鉄道公安職員|てつどうこうあんしょくいん|railway police officer (pre-1987)
鉄警隊|てっけいたい|railway police
呼気検査|こきけんさ|breath test; breathalyzer test
バブーシュカ||babushka
バーブシュカ||babushka
バブシカ||babushka
バイオサイバネティクス||biocybernetics
バイオサイバネティックス||biocybernetics
生物衛星|せいぶつえいせい|biosatellite; satellite designed to carry life in space
顕示的消費|けんじてきしょうひ|conspicuous consumption
誇示的消費|こじてきしょうひ|conspicuous consumption
城館|じょうかん|fortified mansion
全仏オープン|ぜんふつオープン|French Open (tennis); Roland-Garros
インボラ||involuntary upgrade; operational upgrade; free upgrade to business or first class on an overbooked flight
カーペットニシキヘビ||carpet python (Morelia spilota); carpet snake
タッチ操作|タッチそうさ|touch controls (e.g. on a smartphone)
観光ホテル|かんこうホテル|tourist hotel
凶害|きょうがい|great harm (esp. to a person); murder
兇害|きょうがい|great harm (esp. to a person); murder
横断線|おうだんせん|cross-cut; crossline; transversal; transverse line
自己回帰モデル|じこかいきモデル|autoregressive model
ＡＲモデル|エーアールモデル|autoregressive model
遠目が利く|とおめがきく|to be able to see far into the distance; to have good long-distance vision
遠目がきく|とおめがきく|to be able to see far into the distance; to have good long-distance vision
吹奏楽部|すいそうがくぶ|concert band (as a school activity); wind ensemble
帰雁|きがん|wild geese returning north in the spring
絞死|こうし|death by strangulation; ligature strangulation
自絞死|じこうし|suicidal ligature strangulation; suicide by strangulation
後備役|こうびえき|service in the second reserve; military reserve force comprised of ex-servicemen
常備兵役|じょうびへいえき|active and (first) reserve duty
ビンジパージ症候群|ビンジパージしょうこうぐん|binge-purge syndrome
この人|このひと|this person
此の人|このひと|this person
言い切り|いいきり|affirmation; declaration; assertion
言い切り|いいきり|end of sentence
言切り|いいきり|affirmation; declaration; assertion
言切り|いいきり|end of sentence
カバーストーリー||cover story (in a magazine); cover article
カバー・ストーリー||cover story (in a magazine); cover article
消費者主義|しょうひしゃしゅぎ|advocacy of consumer rights (product safety, accurate labelling, etc.); consumer activism; consumer advocacy
消費者主義|しょうひしゃしゅぎ|consumer spending; high levels of consumption
市民ラジオ|しみんラジオ|citizens band radio; CB radio
白杖|はくじょう|white cane (for the blind or visually impaired)
心臓弁膜|しんぞうべんまく|heart valve
弁膜症|べんまくしょう|valvular disease; valvular heart disease
血管弁膜|けっかんべんまく|valve of the veins
人工心臓弁|じんこうしんぞうべん|artificial heart valve
大動脈弁|だいどうみゃくべん|aortic valve
大動脈瘤|だいどうみゃくりゅう|aortic aneurysm
カマボコテント||tunnel tent
カマボコ・テント||tunnel tent
トンネルテント||tunnel tent
トンネル・テント||tunnel tent
フィン語|フィンご|Finnish (language)
ノースリ||sleeveless clothing
スオミ語|スオミご|Finnish (language)
スオミ||Finland
黙聴|だまテン|being in tenpai but not calling riichi
闇聴|やみテン|being in tenpai but not calling riichi
社名版|しゃめいばん|fascia signage; company nameplate
精神分析学|せいしんぶんせきがく|(study of) psychoanalysis
超越論哲学|ちょうえつろんてつがく|transcendental philosophy
非我|ひが|non-ego (philosophy); not-self
ボンナイフ||small folding knife with a rectangular blade used to sharpen pencils
コンビネーションプライヤー||slip joint pliers
コンビネーション・プライヤー||slip joint pliers
ポブラノ||poblano (pepper)
ポブラーノ||poblano (pepper)
モーレ||mole (Mexican sauce)
吹部|すいぶ|concert band (at a school); wind ensemble
ミッキーナイフ||small folding knife with a rectangular blade used to sharpen pencils
ミッキー・ナイフ||small folding knife with a rectangular blade used to sharpen pencils
最恐|さいきょう|scariest; most frightening
最怖|さいきょう|scariest; most frightening
総天然色|そうてんぜんしき|Technicolor
肥後守|ひごのかみ|higonokami; type of folding knife with metal handle
降伏強度|こうふくきょうど|yield strength; yield stress
肉薄|にくうす|thin (of meat)
事前確率分布|じぜんかくりつぶんぷ|prior probability distribution
磨き布|みがきぬの|polishing cloth
事前分布|じぜんぶんぷ|prior probability distribution; prior distribution; prior
乳幼児突然死症候群|にゅうようじとつぜんししょうこうぐん|sudden infant death syndrome; SIDS; cot death; crib death
情にほだされる|じょうにほだされる|to feel compassion towards; to be swayed by emotion; to be moved by
情に絆される|じょうにほだされる|to feel compassion towards; to be swayed by emotion; to be moved by
鍬形草|くわがたそう|Veronica miqueliana (species of speedwell)
クワガタソウ||Veronica miqueliana (species of speedwell)
現姓|げんせい|one's current family name; woman's family name after she married
コットンセット||amenity kit; kit containing cotton swabs, wipes, etc., provided by hotels
コットン・セット||amenity kit; kit containing cotton swabs, wipes, etc., provided by hotels
英国病|えいこくびょう|British disease; Britain's 1970s economic and labour problems
環境工学|かんきょうこうがく|environmental engineering
環境技術|かんきょうぎじゅつ|environmental technology; envirotech; green technology; greentech
環境化学|かんきょうかがく|environmental chemistry
サステイナビリティ学|サステイナビリティがく|sustainability science
舟路|しゅうろ|sea route; voyage; ocean trip
ダウンサイズ||downsizing
司令船|しれいせん|command module (e.g. Apollo's); CM
機械船|きかいせん|service module (e.g. Apollo's)
司令・機械船|しれいきかいせん|command-service module (e.g. Apollo spacecraft); CSM
地球の出|ちきゅうので|earthrise
四槓子|スーカンツ|winning hand consisting of four kongs and a pair
教育工学|きょういくこうがく|educational technology; education technology
九蓮宝燈|チューレンポウトウ|nine gates; winning hand composed of 1-1-1-2-3-4-5-6-7-8-9-9-9 of the same suit plus one additional tile of the same suit
脳写|のうしゃ|encephalography
ドキュドラマ||docudrama; documentary drama
流し満貫|ながしまんがん|win by discarding nothing but terminal and honor tiles in an otherwise drawn round
バンパーカー||bumper car; dodgem
バンパー・カー||bumper car; dodgem
ドッジェム||dodgem; bumper car
ダッジェム||dodgem; bumper car
悪魔の証明|あくまのしょうめい|probatio diabolica; devil's proof
集中排除|しゅうちゅうはいじょ|decentralization; deconcentration
二盃口|リャンペーコー|winning hand composed of two sets of two identical chows plus a pair
低温生物学|ていおんせいぶつがく|cryobiology; low-temperature biology
人体冷凍保存|じんたいれいとうほぞん|cryonics
コールドスリープ||cold sleep; suspended animation
コールド・スリープ||cold sleep; suspended animation
河底撈魚|ホーテイラオユイ|win on the last discard of a round
河底撈魚|ホウテイラオユイ|win on the last discard of a round
低温物理学|ていおんぶつりがく|cryogenics; cryophysics
極限環境微生物|きょくげんかんきょうびせいぶつ|extremophile; organism that thrives in extreme conditions
殺虫灯|さっちゅうとう|light trap; electric insect killer; bug zapper
ヘッドバンド||headband; headstrap; circlet
バイアス電圧|バイアスでんあつ|bias voltage
カナル||canal
ネックバンド||neckband (e.g. headphones, shirt); choker
ノイズキャンセリング||noise-cancelling (e.g. headphones)
ノイズ・キャンセリング||noise-cancelling (e.g. headphones)
セルフカバー||new release of a song by the original artist or composer
セルフ・カバー||new release of a song by the original artist or composer
共紙|ともがみ|paper of the same material, colour, etc.; same type of paper
後光効果|ごこうこうか|halo effect
光背効果|こうはいこうか|halo effect
ノイズキャンセリングヘッドホン||noise-canceling headphones
ノイズ・キャンセリング・ヘッドホン||noise-canceling headphones
地面師|じめんし|land swindler; fraudulent land broker
移籍金|いせききんがく|transfer fee (e.g. in football)
台襟|だいえり|neckband (of a shirt)
置き配|おきはい|delivery service where package is left in front of door or in designated area; safe drop
化性|かせい|voltinism
首ひも|くびひも|neckband (usu. ornamental); lanyard
首紐|くびひも|neckband (usu. ornamental); lanyard
人工冬眠|じんこうとうみん|artificial hibernation; induced hibernation
黄変症|おうへんしょう|xanthochromism; xanthochroism; xanthism
閉鎖音|へいさおん|stop; stop consonant; occlusive
ウエイトベルト||weight belt (diving)
ウェイトベルト||weight belt (diving)
ウエートベルト||weight belt (diving)
ウェートベルト||weight belt (diving)
ウエイト・ベルト||weight belt (diving)
ウェイト・ベルト||weight belt (diving)
ウエート・ベルト||weight belt (diving)
ウェート・ベルト||weight belt (diving)
四文字熟語|よんもじじゅくご|four-character compound word (usu. idiomatic)
米銀|べいぎん|American banks; American bank; American banking sector
カヴァ||kava (Piper methysticum); cava; kavakava
カヴァ||cava; Spanish sparkling wine
カバ||kava (Piper methysticum); cava; kavakava
カバ||cava; Spanish sparkling wine
気がそれる|きがそれる|to be distracted
気が逸れる|きがそれる|to be distracted
ちゃかちゃか||restlessly; restively; agitated; fidgety
ビフォーアフター||before-and-after (photos)
ビフォー・アフター||before-and-after (photos)
バイアス抵抗|バイアスていこう|bias resistance
小蜜柑草|こみかんそう|chamberbitter (Phyllanthus urinaria); gripeweed; shatterstone; stonebreaker; leafflower
コミカンソウ||chamberbitter (Phyllanthus urinaria); gripeweed; shatterstone; stonebreaker; leafflower
雨垂れ落ち|あまだれおち|place where raindrops fall from the eaves
雨だれ落ち|あまだれおち|place where raindrops fall from the eaves
エンコ||encoding
油滴|ゆてき|drop of oil
悪魔崇拝|あくますうはい|devil worship; diabolism; diabolatry; Satanism
宝灯|ほうとう|lighted lamp (or candle, etc.) provided as a religious offering; votive light
宝燈|ほうとう|lighted lamp (or candle, etc.) provided as a religious offering; votive light
被殻|ひかく|putamen (part of brain)
被殻|ひかく|frustule; silicified cell wall of a diatom
裏垢|うらあか|secret account; hidden account (e.g. online service)
裏アカ|うらアカ|secret account; hidden account (e.g. online service)
留心|りゅうしん|heeding; paying attention; bearing in mind
ボタニカル||botanical
貞実|ていじつ|faithful; devoted; true; honest; sincere
東|トン|east wind tile
東|トン|winning hand with a pung (or kong) of east wind tiles
南|ナン|south wind tile
南|ナン|winning hand with a pung (or kong) of south wind tiles
西|シャー|west wind tile
西|シャー|winning hand with a pung (or kong) of west wind tiles
北|ペー|north wind tile
北|ペー|winning hand with a pung (or kong) of north wind tiles
暴風警報|ぼうふうけいほう|storm warning
ナイトプール||swimming pool that is open at night (esp. for a party)
ナイト・プール||swimming pool that is open at night (esp. for a party)
気持ちが悪い|きもちがわるい|bad-feeling; disagreeable; unpleasant; revolting; gross; disgusting
すまた||off tempo; out of tune
すまた||being off the mark; wrong guess; miscalculation
純全帯公九|ジュンチャンタイヤオチュウ|winning hand with at least one terminal tile in each set and no honor tiles
純全帯ヤオ九|ジュンチャンタイヤオチュウ|winning hand with at least one terminal tile in each set and no honor tiles
純全帯么九|ジュンチャンタイヤオチュウ|winning hand with at least one terminal tile in each set and no honor tiles
純チャン|ジュンチャン|winning hand with at least one terminal tile in each set and no honor tiles
節操がない|せっそうがない|inconstant; unprincipled
節操が無い|せっそうがない|inconstant; unprincipled
混全帯公九|ホンチャンタイヤオチュウ|winning hand with at least one terminal or honor tile in each set
混全帯ヤオ九|ホンチャンタイヤオチュウ|winning hand with at least one terminal or honor tile in each set
混全帯么九|ホンチャンタイヤオチュウ|winning hand with at least one terminal or honor tile in each set
チャンタ||winning hand with at least one terminal or honor tile in each set
インスタ映え|インスタばえ|looking attractive on Instagram; something that will look good on Instagram
混老頭|ホンロウトウ|winning hand consisting only of terminal and honor tiles
コフレ||makeup set
コフレ||coffret; small box
インスタジェニック||instagenic; visually appealing if posted on Instagram
宴もたけなわ|えんもたけなわ|party in full swing; party at its peak
宴も酣|えんもたけなわ|party in full swing; party at its peak
自風|じかぜ|seat wind
スパダリ||eligible bachelor
えずくろしい||unpleasant; gross; gaudy
えづくろしい||unpleasant; gross; gaudy
矮鶏大戟|ちゃぼたいげき|petty spurge (Euphorbia peplus)
チャボタイゲキ||petty spurge (Euphorbia peplus)
チンチン||hot (e.g. tea)
ちんちん||hot (e.g. tea)
ちんちこちん||very hot (e.g. tea) (Nagoya dialect)
梅雨の走り|つゆのはしり|rainy spells just before the rainy season
梅雨のはしり|つゆのはしり|rainy spells just before the rainy season
ちんちんもがもが||children's game in which one skips on one leg
電波塔|でんぱとう|radio tower
吝かではない|やぶさかではない|ready (to do); willing
吝かでは無い|やぶさかではない|ready (to do); willing
ミレニアル世代|ミレニアルせだい|millennial generation
砲銅|ほうどう|gun metal
維新の三傑|いしんのさんけつ|three great nobles of the Restoration (Okubo Toshimichi, Saigo Takamori and Kido Takayoshi); three statesmen who played an important role during the Meiji Restoration
ミレニアルズ||millenials
サバイバーズギルト||survivor's guilt; survivor guilt
サバイバーズ・ギルト||survivor's guilt; survivor guilt
カナル線|カナルせん|canal ray
カナル型|カナルがた|canalphones; in-ear headphones
草木もなびく|くさきもなびく|to bow (in great numbers) to a greater authority; to be drawn (en masse) to something attractive; even the plants yield
草木も靡く|くさきもなびく|to bow (in great numbers) to a greater authority; to be drawn (en masse) to something attractive; even the plants yield
ギルト債|ギルトさい|gilt-edged security; gilt-edged bond
金縁証券|きんぶちしょうけん|gilt-edged securities; gilt-edged bond
写真共有|しゃしんきょうゆう|photo-sharing (e.g. app, website, service, etc.); photograph sharing
資本資産|しほんしさん|capital assets
現金資産|げんきんしさん|cash assets
資本資産評価モデル|しほんしさんひょうかモデル|capital asset pricing model; CAPM
文法学者|ぶんぽうがくしゃ|grammarian
菓子店|かしてん|confectioner; confectionery; candy store
のー饅頭|のーまんじゅう|no-manjū; Okinawan sweet manjū with hiragana "no" written on it
削去|さっきょ|removal; deletion
モキュメンタリー||mockumentary
突発性難聴|とっぱつせいなんちょう|sudden deafness; SD; sudden sensorineural hearing loss; SSHL
並行コーパス|へいこうコーパス|parallel corpora
平行コーパス|へいこうコーパス|parallel corpora
黒闇天|こくあんてん|Kalaratri (Deva)
三傑|さんけつ|three great people (e.g. of the Meiji Restoration)
ごてつく||to be confused; to be in disorder; to be chaotic
ごてつく||to have troubles; to be in a dispute
ごてつく||to complain vigorously; to complain persistently
ごてる||to grumble; to complain
洋鵡|ようむ|grey parrot (Psittacus erithacus); African grey parrot
ヨウム||grey parrot (Psittacus erithacus); African grey parrot
日本語学者|にほんごがくしゃ|Japanese language specialist; linguist specializing in Japanese
四大文法|よんだいぶんぽう|the four great Japanese grammar texts (Yamada, Matsushita, Hashimoto and Tokieda)
少年裁判所|しょうねんさいばんしょ|juvenile court
袖枕|そでまくら|using the sleeves of one's kimono as a pillow
政府支援機関|せいふしえんきかん|government-backed institution; government sponsored enterprise; GSE
拡大家族|かくだいかぞく|extended family
青年実業家|せいねんじつぎょうか|young businessman
直接民主主義|ちょくせつみんしゅしゅぎ|direct democracy
十傑|じっけつ|ten best people (in a particular field)
野戦食|やせんしょく|field ration
携帯糧秣|けいたいりょうまつ|military provisions
ミリメシ||military rations
ミリめし||military rations
缶飯|かんめし|canned meal (e.g. military ration)
カンメシ||canned meal (e.g. military ration)
拡張家族|かくちょうかぞく|extended family
コンバットレーション||combat ration; field ration; ration pack
コンバット・レーション||combat ration; field ration; ration pack
行動食|こうどうしょく|high-energy food (climbing, etc.); backpacking food; provisions; rations
ノイジー||noisy
オルトレキシア||orthorexia; orthorexia nervosa
フィプロニル||fipronil (insecticide)
草本帯|そうほんたい|floral zone; herb zone
床の海|とこのうみ|bed wet from tears
就働|しゅうどう|being employed; working
ガンシップ||gunship
高級官僚|こうきゅうかんりょう|elite bureaucrat; high government official; high-ranking bureaucrat; senior government official
簡牘|かんどく|letter; missive; note
簡牘|かんとく|letter; missive; note
竿牘|かんどく|letter; missive; note
竿牘|かんとく|letter; missive; note
眼疾患|がんしっかん|eye disease
原田病|はらだびょう|Harada's disease; Vogt-Koyanagi-Harada disease; VKH disease
陸亀|りくがめ|tortoise
リクガメ||tortoise
アルダブラゾウガメ||Aldabra giant tortoise (Aldabrachelys gigantea)
老年学|ろうねんがく|gerontology
リクガメ科|リクガメか|Testudinidae; tortoise family
陸亀科|りくがめか|Testudinidae; tortoise family
フードスタンプ||food stamp (US federal aid program)
フード・スタンプ||food stamp (US federal aid program)
第四世界|だいよんせかい|Fourth World
第一世界|だいいちせかい|First World
第二世界|だいにせかい|Second World
社会環境|しゃかいかんきょう|social environment; social conditions
スパイラライザー||spiralizer; spiral vegetable slicer
自由民権運動|じゆうみんけんうんどう|Movement for Civic Rights and Freedom (Meiji era); Freedom and People's Rights Movement
気難し屋|きむずかしや|person who is hard to please; difficult person; grouch; sourpuss
むずかし屋|むずかしや|person who is hard to please; grouch; complainer; whiner
難し屋|むずかしや|person who is hard to please; grouch; complainer; whiner
下部屋|しもべや|servants' quarters; room for servants
庭場|にわば|territory of a stall vendor
庭場|にわば|spot on a farm where the harvest would be put in order (Edo period)
味得|みとく|appreciating fully (e.g. work of art)
味到|みとう|appreciating fully (e.g. work of art)
すぽり||snugly (into hole, container, etc.); tightly (fitting, covering); firmly
すぽり||(with a) pop (i.e. sound of a cork, etc. being pulled out of a hole in one movement); with a plop; (fall) straight
アンカーウーマン||anchorwoman
時計学|とけいがく|horology
書卓|しょたく|study desk
死にゲー|しにゲー|video game in which the player is likely to die frequently
椰子鸚鵡|やしおうむ|palm cockatoo (Probosciger aterrimus); goliath cockatoo; great black cockatoo
ヤシオウム||palm cockatoo (Probosciger aterrimus); goliath cockatoo; great black cockatoo
椰子鳥|やしどり|palmchat (Dulus dominicus)
ヤシドリ||palmchat (Dulus dominicus)
パームシュガー||palm sugar
パーム・シュガー||palm sugar
やし糖|やしとう|palm sugar
ヤシ糖|ヤシとう|palm sugar
椰子糖|やしとう|palm sugar
届け出で|とどけいで|report; notification
応接に暇がない|おうせつにいとまがない|too busy to deal with; unable to keep up
応接にいとまがない|おうせつにいとまがない|too busy to deal with; unable to keep up
ラクサ||laksa (Chinese-Malaysian noodle soup)
ココナッツジュース||coconut water; coconut juice
ココナツジュース||coconut water; coconut juice
ココナッツ・ジュース||coconut water; coconut juice
ココナツ・ジュース||coconut water; coconut juice
達磨ストーブ|だるまストーブ|potbelly stove
ダルマストーブ||potbelly stove
とうと||completely; thoroughly
とうと||exactly; precisely
とうと||comfortably
とうと||not at all
とうと||solidly; firmly
とうど||completely; thoroughly
とうど||exactly; precisely
とうど||comfortably
とうど||not at all
とうど||solidly; firmly
裸踊り|はだかおどり|naked dance; dancing naked; striptease; strip show
敗る|やぶる|to defeat; to beat
大実椰子|おおみやし|sea coconut (Lodoicea maldivica); coco de mer; double coconut
オオミヤシ||sea coconut (Lodoicea maldivica); coco de mer; double coconut
偶奇性|ぐうきせい|parity
温蔵庫|おんぞうこ|heating cabinet; warming drawer
グレーマーケット||grey market; gray market
グレー・マーケット||grey market; gray market
グレーエリア||gray area; grey area
グレイエリア||gray area; grey area
グレー・エリア||gray area; grey area
グレイ・エリア||gray area; grey area
好気性|こうきせい|aerotropism
好気性|こうきせい|aerobic; aerotropic
保修|ほしゅう|maintenance
動ともすると|ややともすると|being apt to; being liable to; being inclined to
歯科矯正学|しかきょうせいがく|orthodontics; orthodontia
制度疲労|せいどひろう|institutional fatigue; systemic fatigue
管理上|かんりじょう|administrative
行政上|ぎょうせいじょう|administrative
プラッツ||laboratory bench
プラッツ||fume hood
袖無し羽織|そでなしばおり|sleeveless haori
袖無羽織|そでなしばおり|sleeveless haori
至上主義|しじょうしゅぎ|supremacism
からけし||charcoal
甘蕉|かんしょう|banana
実芭蕉|みばしょう|banana
ミバショウ||banana
犬戎|けんじゅう|Quanrong; ethnic group from northwest of China during the Zhou dynasty (1046–221 BCE)
二体問題|にたいもんだい|two-body problem
多体問題|たたいもんだい|n-body problem; many-body problem
注音符号|ちゅういんふごう|Bopomofo; Zhuyin fuhao; Chinese transliteration system now used mainly in Taiwan
注音符号|ちゅうおんふごう|Bopomofo; Zhuyin fuhao; Chinese transliteration system now used mainly in Taiwan
マクロ分析|マクロぶんせき|macroanalysis; macroeconomic analysis
巨視的分析|きょしてきぶんせき|macroanalysis
ミディスカート||midiskirt; midi skirt
ミモレット||Mimolette (cheese)
レボドパ||levodopa; L-DOPA
Ｌドーパ|エルドーパ|L-DOPA
ツモる||to draw a tile from the wall
ツモる||to win on a self-drawn tile
チーズ壁蝨|チーズだに|cheese mite
チーズダニ||cheese mite
差動歯車|さどうはぐるま|differential gear
差動歯車装置|さどうはぐるまそうち|differential gear
差動装置|さどうそうち|differential gear
アペラシオンドリジーヌコントローレ||protected designation of origin (France); AOC
アペラシオン・ドリジーヌ・コントロレ||protected designation of origin (France); AOC
バノン||Banon (cheese)
エポワス||Époisses de Bourgogne (cheese)
カンタル||Cantal (cheese)
離職票|りしょくひょう|letter of separation; unemployment slip; separation slip
サーベイメーター||radiation surveymeter; portable Geiger counter
サーベイメータ||radiation surveymeter; portable Geiger counter
サーベイ・メーター||radiation surveymeter; portable Geiger counter
サーベイ・メータ||radiation surveymeter; portable Geiger counter
膿栓|のうせん|tonsillolith; tonsil stone
天秤ばかり|てんびんばかり|balance scale; balance
てんびん秤|てんびんばかり|balance scale; balance
天秤秤|てんびんばかり|balance scale; balance
パイ型|パイがた|pie tin; pie dish
栓子|せんし|embolus
栓塞|ぜんそく|embolus
馬産|ばさん|breeding horses
種牝馬|しゅひんば|mare used for breeding; brood mare
産駒|さんく|horse offspring
三鞭酒|さんべんしゅ|Champagne
三鞭酒|しゃんぱん|Champagne
繁殖用|はんしょくよう|brood; stud; stock; breeding
軽四輪|けいよんりん|four-wheeled light vehicle
軽四|けいよん|four-wheeled light vehicle
一向|ひたぶる|determined; single-minded; intent; desperate; wild
頓|ひたぶる|determined; single-minded; intent; desperate; wild
戯言|ぎげん|joke; jest
戲言|ぎげん|joke; jest
花六|はなろく|rabbity six (standard dead shape in go); rabbitty six
国音字母|ちゅうおんじぼ|Bopomofo; Chinese transliteration system now used mainly in Taiwan
国音字母|ちゅういんじぼ|Bopomofo; Chinese transliteration system now used mainly in Taiwan
型幅|かたはば|interior breadth (of a ship); molded breadth
コールアンドレスポンス||call and response
コール・アンド・レスポンス||call and response
レスターシャーレッド||red Leicester (cheese); red Leicestershire
レスターシャー・レッド||red Leicester (cheese); red Leicestershire
積み棒|つみぼう|100-point sticks deposited on the table after dealer win
親家|おやチャ|dealer; east player
子家|こチャ|non-dealer player
翻|ハン|double; unit used in calculation of a hand's score
翻|ファン|double; unit used in calculation of a hand's score
飜|ハン|double; unit used in calculation of a hand's score
飜|ファン|double; unit used in calculation of a hand's score
包有|ほうゆう|inclusion
包有|ほうゆう|to include; to comprise
包有物|ほうゆうぶつ|inclusion; enclave; enclosure
経済主体|けいざいしゅたい|economic unit; economic agent; economic entity
レバレッジドバイアウト||leveraged buyout; LBO
レバレッジド・バイアウト||leveraged buyout; LBO
手投げ|てなげ|throwing with the hand
プルマンベッド||Pullman bed; raised pull-down bed (in a train, ship, etc.)
プルマン・ベッド||Pullman bed; raised pull-down bed (in a train, ship, etc.)
自分撮り|じぶんどり|taking a picture or video of oneself
セルフィー||selfie
セルフィ||selfie
供え物|そなえもの|offering (e.g. to the gods); votive offering
バーテープ||bar tape (for bicycles)
バー・テープ||bar tape (for bicycles)
ロードバイク||road bike
ロード・バイク||road bike
油玉|あぶらだま|droplet of oil floating on water
油球|あぶらだま|droplet of oil floating on water
一糸乱れぬ|いっしみだれぬ|perfectly ordered; perfectly coordinated
低速ギヤ|ていそくギヤ|low gear; low-speed gear
高速ギヤ|こうそくギヤ|high gear; top gear; high-speed gear
特定厨|とくていちゅう|person in the online community who seeks to identify others from the information they post online, or who tries to identify places and objects that appear in comics or games
騒く|ぞめく|to frolic; to revel; to make merry
船外活動|せんがいかつどう|extravehicular activity; EVA
小獣|しょうじゅう|small animal (mammal)
吐き気がする|はきけがする|to feel nauseous
ハイト||height
団練|だんれん|type of local militia most active during the Qing dynasty
脱亜論|だつあろん|Argument for Leaving Asia; editorial written in 1885 by Fukuzawa Yukichi arguing that Japan should align itself with the West rather than China and Korea; Datsu-A Ron
瀬戸内式気候|せとうちしききこう|climate of the Setouchi Region
プラスマイナスゼロ||no profit; no gain; no loss or gain
プラス・マイナス・ゼロ||no profit; no gain; no loss or gain
汚れ仕事|よごれしごと|dirty work; unpleasant task
定型的|ていけいてき|typical; standard; fixed; stereotyped
一刻の猶予もない|いっこくのゆうよもない|not a moment to waste; there is no time to lose; cannot wait any longer
一刻の猶予も無い|いっこくのゆうよもない|not a moment to waste; there is no time to lose; cannot wait any longer
水団|すいとん|flour dumplings in soup
受託手荷物|じゅたくてにもつ|checked baggage
摂氏温度|せっしおんど|degrees Celsius
大事|おおごと|serious matter; major incident; matter of grave concern; crisis
大ごと|おおごと|serious matter; major incident; matter of grave concern; crisis
結束バンド|けっそくバンド|cable tie; zip tie
南流|なんりゅう|flowing south (e.g. of a river)
今い|いまい|current; hip; trendy; fashionable; stylish
イマい||current; hip; trendy; fashionable; stylish
着艦|ちゃっかん|landing on an aircraft carrier; deck-landing
着艦|ちゃっかん|reaching a warship; arrival of a warship (at a port)
北流|ほくりゅう|flowing north (e.g. of a river)
東流|とうりゅう|flowing east (e.g. of a river)
西流|せいりゅう|flowing west (e.g. of a river)
締め具|しめぐ|clamp; clasp; fastener; binding
締具|しめぐ|clamp; clasp; fastener; binding
癆症|ろうしょう|tabes; phthisis; pulmonary tuberculosis
労症|ろうしょう|tabes; phthisis; pulmonary tuberculosis
搶槓|チャンカン|winning on a tile robbed from another player's kong
槍槓|チャンカン|winning on a tile robbed from another player's kong
訂す|ただす|to correct (a typo, etc.)
手汗|てあせ|palm sweat
不当解雇|ふとうかいこ|unfair dismissal; wrongful dismissal; unfair termination
絆す|ほだす|to fetter; to shackle; to bind
海軍陸戦隊|かいぐんりくせんたい|naval brigade; naval land forces
暗号法|あんごうほう|cryptography
洗い矢|あらいや|ramrod; cleaning rod
脚荷|あしに|ballast (for a ship)
尾輪|びりん|tail wheel (aircraft)
ドッグラン||dog park
ドッグ・ラン||dog park
特任教授|とくにんきょうじゅ|specially-appointed professor
着港|ちゃっこう|arrival (in port)
欧文脈|おうぶんみゃく|Japanese containing expressions literally translated from European languages
ラプス||lapse
微速度撮影|びそくどさつえい|time-lapse photography
タイムラプス||time-lapse
ホウケイ酸|ホウケイさん|borosilicic acid
硼珪酸|ほうけいさん|borosilicic acid
ホウケイ酸ガラス|ホウケイさんガラス|borosilicate glass
硼珪酸ガラス|ほうけいさんガラス|borosilicate glass
ホウケイ酸塩|ホウケイさんえん|borosilicate
硼珪酸塩|ほうけいさんえん|borosilicate
俳諧味|はいかいみ|haiku-like quality; clever feeling; witty flavor
ユーチューバー||YouTuber; YouTube celebrity
せんべろ||very cheap drinking place; getting drunk for 1000 yen
大を成す|だいをなす|to achieve greatness; to achieve success
高身長|こうしんちょう|large statured; tall
体液沸騰|たいえきふっとう|ebullism; formation of gas bubbles in bodily fluids
華壇|かだん|world of ikebana; ikebana circles
共同浴|きょうどうよく|public bathing; public bath
黒犬|くろいぬ|black dog
白犬|しろいぬ|white dog
全国瞬時警報システム|ぜんこくしゅんじけいほうシステム|nationwide instantaneous alert system; J-Alert system; Japan's satellite-based disaster warning system
Ｊアラート|ジェーアラート|J-Alert system; nationwide instantaneous alert system; Japan's satellite-based disaster warning system
発|ハツ|green dragon tile
発|ハツ|winning hand with a pung (or kong) of green dragon tiles
發|ハツ|green dragon tile
發|ハツ|winning hand with a pung (or kong) of green dragon tiles
ナウキャスト||nowcast; prediction of the very near future (esp. one hour weather forecast)
ネオファシスト||neo-fascist
素っ惚ける|すっとぼける|to feign ignorance; to pretend one doesn't know
素っ恍ける|すっとぼける|to feign ignorance; to pretend one doesn't know
分子エレクトロニクス|ぶんしエレクトロニクス|molecular electronics
モレクトロニクス||molectronics; molecular electronics
通貨学派|つうかがくは|currency school; British currency school
夏の大三角|なつのだいさんかく|Summer Triangle (asterism)
冬の大三角|ふゆのだいさんかく|Winter Triangle (asterism)
ベアバック||bareback clothes; clothes which leave a woman's back exposed
ベアバック||bareback riding
春の大三角|はるのだいさんかく|Spring Triangle (asterism)
ニセ十字|ニセじゅうじ|False Cross (asterism)
にせ十字|にせじゅうじ|False Cross (asterism)
偽十字|にせじゅうじ|False Cross (asterism)
ベアミドリフ||bare midriff (clothing style that exposes one's midriff)
ベア・ミドリフ||bare midriff (clothing style that exposes one's midriff)
モノキニ||monokini; one piece swimsuit with an exposed back
モノキニ||bikini briefs
原理運動|げんりうんどう|Moon movement; Moonism; Unificationism
月震|げっしん|moonquake
マクシスカート||maxiskirt; maxi skirt; ankle-length skirt
計測学|けいりょうがく|metrology
人年|じんねん|person-year; man-year
メディアイベント||media event
メディア・イベント||media event
メディケア||Medicare (US)
微気象|びきしょう|micrometeorogical phenomenon
超ミニスカート|ちょうミニスカート|micro miniskirt; micro skirt; micromini
ロンゲット||longuette; knee-length skirt
中締め|なかじめ|closing mid-way
中締め|なかじめ|taking a break mid-way through an event, sometimes with ceremonial hand-clapping
サージェリー||surgery
サージャリー||surgery
ベアショルダー||bare shoulder (clothing style); off-the-shoulder
ベア・ショルダー||bare shoulder (clothing style); off-the-shoulder
アマチュアレスリング||amateur wrestling
アマチュア・レスリング||amateur wrestling
アマレス||amateur wrestling
ハガキ職人|ハガキしょくにん|regular respondent to a periodical or radio program
陽性的中率|ようせいてきちゅうりつ|positive predictive value
園路|えんろ|garden path; path through a park
盤上|ばんじょう|on the board (shogi, go, etc.)
遠距離早期警戒線|えんきょりそうきけいかいせん|Distant Early Warning Line (US, Canada); DEW Line
早期警戒|そうきけいかい|early warning
異常天候早期警戒情報|いじょうてんこうそうきけいかいじょうほう|early warning information on extreme weather
早期警戒情報|そうきけいかいじょうほう|Shared Early Warning; SEW; radar and satellite-based system for setecting missile, etc. attacks
早期警戒情報|そうきけいかいじょうほう|early warning information on extreme weather
通貨主義|つうかしゅぎ|currency principle; currency doctrine
イラスト入り|イラストいり|illustrated
女の子の日|おんなのこのひ|Girls' Day; Dolls' Festival; Hinamatsuri
女の子の日|おんなのこのひ|menstrual day; menstrual period
ミドリフ||midriff; upper abdomen
ミドリフ||clothing that exposes the midriff
ミドリフトップ||midriff top; crop top; belly shirt
ミドリフ・トップ||midriff top; crop top; belly shirt
鞍鼻|あんび|saddle nose
じゃらし||cat teaser (cat toy); kitty teaser
鞍尻|くらじり|rear part of saddle; cantle
ぽっこり||bloated (esp. stomach); bulging; sticking out
ぽっこり||gaping wide; caving in
ポッコリ||bloated (esp. stomach); bulging; sticking out
ポッコリ||gaping wide; caving in
時法|じほう|time convention; way of dividing day into hours; hour system
時辰|じしん|time; hour
ご案内|ごあんない|acquaintance; knowledge
御案内|ごあんない|acquaintance; knowledge
天が抜ける|あまがぬける|the skies open up (heavy rain)
グル||guru
グルイーノ||gluino (hypothetical elementary particle)
フォティーノ||photino (hypothetical elementary particle)
グラビティーノ||gravitino (hypothetical elementary particle)
グラヴィティーノ||gravitino (hypothetical elementary particle)
超対称性粒子|ちょうたいしょうせいりゅうし|supersymmetric particle
光茸蝿|ひかりきのこばえ|glowworm
ヒカリキノコバエ||glowworm
ミルク色|ミルクいろ|milk-white; milky
超対称粒子|ちょうたいしょうりゅうし|supersymmetric particle
タイヤハウス||wheel well
タイヤ・ハウス||wheel well
フルーツサンド||fruit sandwich; sandwich filled with fruit and sweetened whipped cream
フルーツ・サンド||fruit sandwich; sandwich filled with fruit and sweetened whipped cream
ショルダーキーボード||keytar
ショルダー・キーボード||keytar
平行調|へいこうちょう|relative key
並行調|へいこうちょう|relative key
ピン留め|ピンどめ|hairpin; bobby pin
訴求力|そきゅうりょく|appeal (e.g. of an advertisement)
セールスポイント||selling point
セールス・ポイント||selling point
フルーツサンドイッチ||fruit sandwich; sandwich filled with fruit and sweetened whipped cream
フルーツ・サンドイッチ||fruit sandwich; sandwich filled with fruit and sweetened whipped cream
セルカ||selfie
ロヒンギャ||Rohingya (people)
丸みを帯びた|まるみをおびた|roundish; sort of round
丸味を帯びた|まるみをおびた|roundish; sort of round
黄色味を帯びた|きいろみをおびた|yellowish; tinged with yellow
黄色みを帯びた|きいろみをおびた|yellowish; tinged with yellow
都有|とゆう|being owned by the Tokyo metropolitan government
ディップス||dips (exercise)
マンタ||manta ray (Manta sp.)
南洋マンタ|なんようマンタ|reef manta ray (Manta alfredi)
ナンヨウマンタ||reef manta ray (Manta alfredi)
流れ寄る|ながれよる|to drift together; to drift to the shore
流れよる|ながれよる|to drift together; to drift to the shore
核分裂連鎖反応|かくぶんれつれんさはんのう|fission chain reaction
キャラクターボイス||voice actor
キャラクター・ボイス||voice actor
ＣＶ|シーヴィー|voice actor
運輸安全委員会|うんゆあんぜんいいんかい|Japan Transport Safety Board; JTSB
水上輸送|すいじょうゆそう|water carriage; water transportation
晩節を汚す|ばんせつをけがす|to ruin one's reputation in later life; to tarnish one's twilight years
構造生物学|こうぞうせいぶつがく|structural biology
政治社会学|せいじしゃかいがく|political sociology
ひげ結晶|ひげけっしょう|(crystal) whisker
髭結晶|ひげけっしょう|(crystal) whisker
オラオラ||pushy; overbearing; self-assured; aggressive
おらおら||pushy; overbearing; self-assured; aggressive
銃士|じゅうし|musketeer
物標|ぶっぴょう|target (e.g. to aid navigation); landmark
ヒートアイランド現象|ヒートアイランドげんしょう|heat island phenomenon; heat island effect
グルテンミート||seitan; meat substitute made from wheat gluten
グルテン・ミート||seitan; meat substitute made from wheat gluten
看板商品|かんばんしょうひん|flagship product; leading product; hallmark product
アダムサイト||adamsite
じわり||gradually; slowly but steadily
鐙革|あぶみがわ|stirrup straps; stirrup leather
あぶみ革|あぶみがわ|stirrup straps; stirrup leather
粟麩|あわぶ|nama-fu (steamed wheat gluten) mixed with chestnuts
粟麸|あわぶ|nama-fu (steamed wheat gluten) mixed with chestnuts
粟ぶ|あわぶ|nama-fu (steamed wheat gluten) mixed with chestnuts
車麩|くるまぶ|yaki-fu (baked wheat gluten) cut in ring-shaped slices (Niigata specialty)
車ぶ|くるまぶ|yaki-fu (baked wheat gluten) cut in ring-shaped slices (Niigata specialty)
車麸|くるまぶ|yaki-fu (baked wheat gluten) cut in ring-shaped slices (Niigata specialty)
桜でんぶ|さくらでんぶ|pink fish floss; fish that has been finely shredded, seasoned and colored pink
桜田麩|さくらでんぶ|pink fish floss; fish that has been finely shredded, seasoned and colored pink
桜田ぶ|さくらでんぶ|pink fish floss; fish that has been finely shredded, seasoned and colored pink
桜田麸|さくらでんぶ|pink fish floss; fish that has been finely shredded, seasoned and colored pink
然しも|さしも|to that extent; so (much)
演台|えんだい|desk for a speaker; lectern
演台|えんだい|rostrum; platform
静音パソコン|せいおんパソコン|quiet PC; personal computer that makes little to no noise
鐙釣|あぶみつり|stirrup straps; stirrup leather
とびっきり||best; extra-fine; superfine; unequalled
とびっきり||exceptionally; extraordinarily; by far
予てより|かねてより|previously; already; beforehand; in advance; for some time
兼ねてより|かねてより|previously; already; beforehand; in advance; for some time
濡れ仏|ぬれぼとけ|Buddhist image in the open
露仏|ろぶつ|Buddhist image in the open
優長|ゆうちょう|superior; excellent; outstanding
ローガンベリー||loganberry (Rubus x loganobaccus)
ボイセンベリー||boysenberry (Rubus ursinus x R. idaeus)
ボイズンベリー||boysenberry (Rubus ursinus x R. idaeus)
ボイゼンベリー||boysenberry (Rubus ursinus x R. idaeus)
デューベリー||dewberry
幌向苺|ほろまいいちご|cloudberry (Rubus chamaemorus)
ホロムイイチゴ||cloudberry (Rubus chamaemorus)
クラウドベリー||cloudberry (Rubus chamaemorus)
ＴＮＴ|ティーエヌティー|trinitrotoluene; TNT
千島苺|ちしまいちご|arctic raspberry (Rubus arcticus)
チシマイチゴ||arctic raspberry (Rubus arcticus)
生命情報学|せいめいじょうほうがく|bioinformatics
管理工学|かんりこうがく|management engineering
数理科学|すうりかがく|mathematical science
レッドアイ||red eye (cocktail)
レッド・アイ||red eye (cocktail)
薬科|やっか|pharmacy (subject)
ツモ切り|ツモぎり|discarding the just-drawn tile
自摸切り|ツモぎり|discarding the just-drawn tile
萬|ワン|counter for character tiles
萬|マン|counter for character tiles
索|ソー|counter for bamboo tiles
索|ソウ|counter for bamboo tiles
筒|ピン|counter for dot tiles
踏み跡|ふみあと|footprints; trail (of someone)
踏みあと|ふみあと|footprints; trail (of someone)
カットガラス||cut glass; faceted glass
カット・ガラス||cut glass; faceted glass
神経生物学|しんけいせいぶつがく|neurobiology
詠春拳|えいしゅんけん|Wing Chun (traditional Chinese martial art)
咏春拳|えいしゅんけん|Wing Chun (traditional Chinese martial art)
道中|みちなか|middle of the road; on the road
道中|みちなか|on the way (to one's destination)
ボディビルディング||bodybuilding
ボディービルディング||bodybuilding
ボディ・ビルディング||bodybuilding
ボディー・ビルディング||bodybuilding
性|なりくせ|disposition; nature; character
にたっと||with a broad grin; smirking
ニタッと||with a broad grin; smirking
合計特殊出生率|ごうけいとくしゅしゅっしょうりつ|total fertility rate; TFR
生物言語学|せいぶつげんごがく|biolinguistics
神経言語学|しんけいげんごがく|neurolinguistics
言語人類学|げんごじんるいがく|linguistic anthropology
理論言語学|りろんげんごがく|theoretical linguistics
民族誌|みんぞくし|ethnography
書き下し|かきくだし|writing from top to bottom
書き下し|かきくだし|writing without a pause
書き下し|かきくだし|translation of classical Chinese into Japanese
書下し|かきくだし|writing from top to bottom
書下し|かきくだし|writing without a pause
書下し|かきくだし|translation of classical Chinese into Japanese
永久運動|えいきゅううんどう|perpetual motion
スープ入れ|スープいれ|soup container; soup bowl
越僑|えっきょう|overseas Vietnamese
一緒くたに|いっしょたくに|jumbling together; lumping together; mixing up
ウンウンエンニウム||ununennium (Uue)
ウンビニリウム||unbinilium (Ubn)
ウンビウニウム||unbiunium (Ubu)
楕円曲線|だえんきょくせん|elliptic curve
種数|しゅすう|genus
超曲面|ちょうきょくめん|hypersurface
超平面|ちょうへいめん|hyperplane
会計監査人|かいけいかんさにん|auditor
火の海|ひのうみ|sea of fire; sea of flame
昭和基地|しょうわきち|Shōwa Station (Antarctica); Showa Station; Syowa Station
高麗海老|こうらいえび|Chinese white shrimp (Fenneropenaeus chinensis); oriental shrimp; fleshy prawn
コウライエビ||Chinese white shrimp (Fenneropenaeus chinensis); oriental shrimp; fleshy prawn
大正海老|たいしょうえび|Chinese white shrimp (Fenneropenaeus chinensis); oriental shrimp; fleshy prawn
タイショウエビ||Chinese white shrimp (Fenneropenaeus chinensis); oriental shrimp; fleshy prawn
馬には乗ってみよ人には添うてみよ|うまにはのってみよひとにはそうてみよ|you can't judge someone until you've spent time with them; you can't judge something until you've tried it; try a horse by riding him, and judge a man by living with him
馬には乗って見よ人には添うて見よ|うまにはのってみよひとにはそうてみよ|you can't judge someone until you've spent time with them; you can't judge something until you've tried it; try a horse by riding him, and judge a man by living with him
大正天皇|たいしょうてんのう|Emperor Taishō (1879-1926, reigned 1912-1926); Emperor Yoshihito
昭和天皇|しょうわてんおう|Emperor Shōwa (1901-1989, reigned 1926-1989); Emperor Showa; Emperor Hirohito
竹夫人|ちくふじん|bamboo wife; Dutch wife
竹婦人|ちくふじん|bamboo wife; Dutch wife
抱き籠|だきかご|bamboo wife; Dutch wife
抱籠|だきかご|bamboo wife; Dutch wife
抱き篭|だきかご|bamboo wife; Dutch wife
抱篭|だきかご|bamboo wife; Dutch wife
切れ目を入れる|きれめをいれる|to make a cut; to make an incision; to score (food)
引っ張りタイヤ|ひっぱりタイヤ|stretched tire (tyre); narrow tire mounted on a wide rim to achieve a low-profile look
サイドウォール||sidewall (of a tire)
覆面算|ふくめんざん|verbal arithmetic; alphametic; cryptarithmetic; cryptarithm; word addition
どうこう言う|どうこういう|to raise objections; to complain; (to have the right) to say anything
如何こう言う|どうこういう|to raise objections; to complain; (to have the right) to say anything
ノルウェー楓|ノルウェーかえで|Norway maple (Acer platanoides)
ノルウェーカエデ||Norway maple (Acer platanoides)
元弘の乱|げんこうのらん|Genkō War (1331-1333); Genkō Incident
元弘の変|げんこうのへん|Genkō Incident (1331-1333); Genkō War
千早城の戦い|ちはやじょうのたたかい|Siege of Chihaya (Genkō War, 1333)
六波羅攻略|ろくはらこうりゃく|Battle of Rokuhara (Genkō War, 1333); Capture of Rokuhara
シンビン||sin bin (rugby)
シン・ビン||sin bin (rugby)
鎌倉の戦い|かまくらのたたかい|Battle of Kamakura (Genkō War, 1333); Siege of Kamakura
建武の新政|けんむのしんせい|Kenmu Restoration (1333-1336)
リーヅモ||riichi with self-draw win (common pair of yaku)
カリナン||Cullinan (diamond)
コイヌール||Koh-i-Noor (diamond)
コーイヌール||Koh-i-Noor (diamond)
コ・イ・ヌール||Koh-i-Noor (diamond)
コー・イ・ヌール||Koh-i-Noor (diamond)
脈なし|みゃくなし|just friends; no romantic interest; no pulse
脈無し|みゃくなし|just friends; no romantic interest; no pulse
レイノルズ数|レイノルズすう|Reynolds number
残材|ざんざい|remaining material; left-over material
レイリー数|レイリーすう|Rayleigh number
レーリー数|レーリーすう|Rayleigh number
グラスホフ数|グラスホフすう|Grashof number
プラントル数|プラントルすう|Prandtl number
マルチモニター||multi-monitor; multi-display
差金決済|さきんけっさい|net settlement; making up differences
差金決済取引|さきんけっさいとりひき|contract for difference; CFD
生牌|ションパイ|tile that has not been discarded once yet
序数詞|じょすうし|ordinal numeral; ordinal number
基数詞|きすうし|cardinal numeral; cardinal number
偽ニュース|にせニュース|fake news
欠かさず|かかさず|without fail; diligently; without missing a single ...
死に追いやる|しにおいやる|to drive to death (e.g. by suicide); to cause to die
死に追い遣る|しにおいやる|to drive to death (e.g. by suicide); to cause to die
陰キャラ|いんキャラ|gloomy person
インキャラ||gloomy person
見違う|みちがう|to hardly recognise; to mistake for something or somebody else
見ちがう|みちがう|to hardly recognise; to mistake for something or somebody else
スクールカースト||practice of grouping students by popularity according to their appearance, interests, personality, etc.
スクール・カースト||practice of grouping students by popularity according to their appearance, interests, personality, etc.
ファーストミット||first baseman's mitt
ファースト・ミット||first baseman's mitt
映画賞|えいがしょう|film award
たがが緩む|たががゆるむ|to weaken (of willpower, solidarity, etc.); to lose one's edge; to become less tense; to become lax (of discipline, rules, etc.)
タガが緩む|タガがゆるむ|to weaken (of willpower, solidarity, etc.); to lose one's edge; to become less tense; to become lax (of discipline, rules, etc.)
箍が緩む|たががゆるむ|to weaken (of willpower, solidarity, etc.); to lose one's edge; to become less tense; to become lax (of discipline, rules, etc.)
たがを外す|たがをはずす|to cut loose; to act without restraint; to throw off all inhibitions; to go wild
タガを外す|タガをはずす|to cut loose; to act without restraint; to throw off all inhibitions; to go wild
箍を外す|たがをはずす|to cut loose; to act without restraint; to throw off all inhibitions; to go wild
ノーベル医学生理学賞|ノーベルいがくせいりがくしょう|Nobel Prize in Physiology or Medicine
ノーベル医学・生理学賞|ノーベルいがくせいりがくしょう|Nobel Prize in Physiology or Medicine
音素配列論|おんそはいれつろん|phonotactics
大篝火|おおかがりび|bonfire
大かがり火|おおかがりび|bonfire
秋夕|しゅうせき|autumn evening
秋夕|しゅうせき|Chuseok; Korean Thanksgiving
秋夕|チュソク|Chuseok; Korean Thanksgiving
濃緑|こみどり|dark green; deep green
濃緑|のうりょく|dark green; deep green
我利我利|がりがり|focussing on only one thing; obsessively; intensely
我利我利|がりがり|selfish; self-serving
ガリガリ||focussing on only one thing; obsessively; intensely
ガリガリ||selfish; self-serving
ノーベル記念経済学賞|ノーベルきねんけいざいがくしょう|Nobel Memorial Prize in Economic Sciences
火山湖|かざんこ|crater lake; volcanic lake
後出しじゃんけん|あとだしじゃんけん|waiting to see one's opponent's move; playing a waiting game
あと出しじゃんけん|あとだしじゃんけん|waiting to see one's opponent's move; playing a waiting game
内旋|ないせん|internal rotation; endorotaion; rotating upper arm or leg inwards towards the body
内旋|ないせん|involution
足留め薬|あしどめぐすり|dye retarding agent; leveling agent
足留薬|あしどめぐすり|dye retarding agent; leveling agent
統失|とうしつ|schizophrenia
氷球|ひょうきゅう|ice hockey
仏暦|ぶつれき|Buddhist calendar
米式蹴球|べいしきしゅうきゅう|American football
ラ式蹴球|ラしきしゅうきゅう|rugby
闘球|とうきゅう|rugby
ピーク時|ピークじ|peak time; peak hours
準備通貨|じゅんびつうか|reserve currency
順番こ|じゅんばんこ|alternating; taking turns
管理栄養士|かんりえいようし|registered dietitian; nationally certified nutritionist
戦力外|せんりょくがい|noninclusion in a team; not being chosen to play
純色|じゅんしょく|pure color (colour); saturated color
ネットワーク中立性|ネットワークちゅうりつせい|net neutrality
ハルキスト||Harukist; fan of author Haruki Murakami
背水|はいすい|backwater
背水|はいすい|standing with one's back to water (river, lake, etc.)
開水路|かいすいろ|open channel (liquid flow)
気腔|きくう|air space; air chamber
板材|いたざい|wooden board; plank
無乳|むにゅう|agalactia; lactation failure
無乳|むにゅう|flat chest; absence of breasts
晩歳|ばんさい|one's later years; final years; old age
ネット中立性|ネットちゅうりつせい|net neutrality
桁が違う|けたがちがう|to be wildly different; to be on a completely different scale; to be in a different league; to be poles apart; to stand no comparison
けたが違う|けたがちがう|to be wildly different; to be on a completely different scale; to be in a different league; to be poles apart; to stand no comparison
受送達者|じゅそうたつしゃ|addressee
憾む|うらむ|to regret
恨む|うらむ|to regret
立憲民主党|りっけんみんしゅとう|Constitutional Democratic Party of Japan (formed in 2017)
お試し版|おためしばん|trial version
埃よけ|ほこりよけ|dust protection; dust cover
埃除け|ほこりよけ|dust protection; dust cover
ほこり除け|ほこりよけ|dust protection; dust cover
ホコリ除け|ホコリよけ|dust protection; dust cover
調節器|ちょうせつき|regulator; adjuster; modulator; controller
タコパ||takoyaki party
特別送達|とくべつそうたつ|special delivery (mail category)
暖簾名|のれんな|store name written on a noren
使い古し|つかいふるし|worn-out
受けやすい|うけやすい|susceptible; vulnerable; prone (to)
受け易い|うけやすい|susceptible; vulnerable; prone (to)
英語学|えいごがく|English studies; English philology; English linguistics
矛山車|ほこだし|parade float decorated with long-handled Chinese spears
鉾山車|ほこだし|parade float decorated with long-handled Chinese spears
液冷|えきれい|liquid cooling
文章家|ぶんしょうか|(skilled) writer; essayist
君子は豹変す|くんしはひょうへんす|A wise man changes his mind, a fool never; The wise adapt themselves to changed circumstances
君子は豹変す|くんしはひょうへんす|The wise make no scruple in suddenly changing their demeanor
ノンアル||non-alcoholic; alcohol-free
脈無し病|みゃくなしびょう|pulseless disease
脈なし病|みゃくなしびょう|pulseless disease
セ氏温度|セしおんど|degrees Celsius
ページ違反|ぺーじいはん|page fault; access violation
ソマイ||somai; type of bola with two balls
税金対策|ぜいきんたいさく|tax planning; tax reduction strategy
租税回避|そぜいかいひ|tax avoidance
威張り屋|いばりや|arrogant person; overbearing person; self-important person; braggart; boaster
威張りや|いばりや|arrogant person; overbearing person; self-important person; braggart; boaster
口吻を漏らす|こうふんをもらす|to give vent to (one's feeling); to hint (at something); to intimate; to suggest
口吻を洩らす|こうふんをもらす|to give vent to (one's feeling); to hint (at something); to intimate; to suggest
口吻をもらす|こうふんをもらす|to give vent to (one's feeling); to hint (at something); to intimate; to suggest
振休|ふりきゅう|substitute national holiday; day off in lieu of a national holiday that falls on a Sunday; compensatory holiday
代替休日|だいたいきゅうじつ|compensatory holiday (for working on a day off)
水蓼|みずたで|water pepper (Persicaria hydropiper)
ミズタデ||water pepper (Persicaria hydropiper)
児の手柏|このてがしわ|oriental arbor-vita (Platycladus orientalis); oriental thuja
児手柏|このてがしわ|oriental arbor-vita (Platycladus orientalis); oriental thuja
コノテガシワ||oriental arbor-vita (Platycladus orientalis); oriental thuja
無形文化遺産|むけいぶんかいさん|intangible cultural heritage
仏滅紀元|ぶつめつきげん|Buddhist calendar
アブダビ||Abu Dhabi (United Arab Emirates)
リージョンコード||region code (e.g. of a DVD)
リージョン・コード||region code (e.g. of a DVD)
磯辺巻き|いそべまき|bite-sized morsels wrapped in nori
折り込み広告|おりこみこうこく|advertising insert (e.g. in a newspaper); inserted flyer
折込み広告|おりこみこうこく|advertising insert (e.g. in a newspaper); inserted flyer
路面店|ろめんてん|street-level store; shop facing the street
アバカス||abacus
冠板|かむりいた|crown plate (armor, building, shipbuilding, etc.)
かむり板|かむりいた|crown plate (armor, building, shipbuilding, etc.)
アバクス||abacus; flat slab forming the top part of the capital of a column
阿片チンキ|あへんチンキ|laudanum; opium tincture
アヘンチンキ||laudanum; opium tincture
アヘン剤|アヘンざい|opiate
呵片剤|あへんざい|opiate
団体精神|だんたいせいしん|team spirit; esprit de corps; corporate spirit
雨外套|あまがいとう|mackintosh; macintosh; raincoat
アネロイド晴雨計|アネロイドせいうけい|aneroid barometer
アンモナル||ammonal (explosive)
アンペア数|アンペアすう|amperage
暗溝|あんこう|subterranean drain; culvert; conduit
合金鉄|ごうきんてつ|ferroalloy
合金鋼|ごうきんこう|alloy steel
鉄合金|てつごうきん|ferroalloy
ミルシート||Mill Test Report; Mill Test Certificate; quality assurance document used in steelmaking industry
フットバス||footbath; foot bath
フット・バス||footbath; foot bath
足浴|そくよく|footbath (for improving blood circulation)
手浴|しゅよく|hand bath (for improving blood circulation)
手浴|てよく|hand bath (for improving blood circulation)
部分浴|ぶんぶよく|partial bath; submerging only part of the body in water
空盒気圧計|くうごうきあつけい|aneroid barometer
ポーランド回廊|ポーランドかいろう|Polish Corridor
回廊地帯|かいろうちたい|corridor (belt of land)
低周波公害|ていしゅうはこうがい|low-frequency noise pollution; low-frequency pollution
スロー地震|スローじしん|slow earthquake
スロースリップ||slow earthquake
スロー・スリップ||slow earthquake
低周波地震|ていしゅうはじしん|low-frequency earthquake
靴の木型|くつのきがた|shoe tree; shoe stretcher; shoemaker's last
先振込み|さきふりこみ|payment in advance (by bank transfer)
先振り込み|さきふりこみ|payment in advance (by bank transfer)
膿痂疹|のうかしん|impetigo
脳虚血|のうきょけつ|cerebral ischemia; brain ischemia
法科学|ほうかがく|forensic science
億劫がる|おっくうがる|to show unwillingness to do; to be reluctant to do
連装|れんそう|coaxial mounting; multiple mounting
単装|たんそう|single mounting
エーレ||øre; Danish or Norwegian monetary unit equal to one hundredth of a krone
エーレ||öre; Swedish monetary unit equal to one hundredth of a krona
オーレ||øre; Danish or Norwegian monetary unit equal to one hundredth of a krone
オーレ||öre; Swedish monetary unit equal to one hundredth of a krona
エイリール||eyrir; Icelandic monetary unit equal to 1/100 króna
オイラル||eyrir; Icelandic monetary unit equal to 1/100 króna
アウラル||eyrir; Icelandic monetary unit equal to 1/100 króna
民間機|みんかんき|civilian aircraft
鉄骨構造|てっこつこうぞう|steel-frame construction; steel structure
敵前上陸|てきぜんじょうりく|landing in the face of the enemy; opposed landing
脳塞栓|のうそくせん|cerebral embolism
コルナ||koruna (Czech or former Slovak currency)
クーナ||kuna (Croatian currency)
レウ||leu (Rumanian or Moldovan currency)
石理|せきり|texture (of a rock); structure
織物組織|おりものそしき|textile weave
石目|いしめ|grain (of rock); rift
漢字仮名交じり文|かんじかなまじりぶん|mixed writing (kanji and kana)
刮眼|かつがん|careful observation; close attention
魚子|ななこ|decorating a metal surface with small dots resembling fish eggs
魚子|ななこ|twill weave; basket weave
斜子|ななこ|decorating a metal surface with small dots resembling fish eggs
斜子|ななこ|twill weave; basket weave
魶子|ななこ|decorating a metal surface with small dots resembling fish eggs
魶子|ななこ|twill weave; basket weave
七子|ななこ|decorating a metal surface with small dots resembling fish eggs
七子|ななこ|twill weave; basket weave
魚々子|ななこ|decorating a metal surface with small dots resembling fish eggs
魚々子|ななこ|twill weave; basket weave
七々子|ななこ|decorating a metal surface with small dots resembling fish eggs
七々子|ななこ|twill weave; basket weave
中蘊|ちゅううん|bardo; state (or period) of intermediate existence between one's death and rebirth (in Japan, 49 days)
静止摩擦|せいしまさつ|static friction
摩擦力|まさつりょく|frictional force
摩擦角|まさつかく|angle of friction; frictional angle
心を癒す|こころをいやす|to soothe one's soul; to raise one's spirits
粋筋|いきすじ|red-light district; pleasure quarters
粋筋|いきすじ|love affair; romance
上元|じょうげん|15th day of the 1st lunar month
下元|かげん|15th day of the 10th lunar month
マリガン||mulligan
乳姉妹|ちきょうだい|foster sister
魚子織り|ななこおり|twill weave; basket weave
斜子織り|ななこおり|twill weave; basket weave
魚子織|ななこおり|twill weave; basket weave
斜子織|ななこおり|twill weave; basket weave
コントゥア||contour
コントゥアー||contour
カントゥア||contour
カントゥアー||contour
電気除細動器|でんきじょさいどうき|defibrillator; cardioverter
カウンターショック||countershock
カウンタショック||countershock
弾性ゴム|だんせいゴム|gum elastic; elastic gum; rubber
石大工|いしだいく|stonemason; mason; master stonemason
雅び男|みやびお|elegant and refined man
サイドキック||side-foot (e.g. in soccer); kick with the side of the foot
サイドキック||side kick (e.g. in martial arts)
サイドキック||sidekick; companion
サイド・キック||side-foot (e.g. in soccer); kick with the side of the foot
サイド・キック||side kick (e.g. in martial arts)
サイド・キック||sidekick; companion
三元|さんげん|15th day of the 1st, 7th and 10th lunar months
三元|さんげん|heaven, earth and man
三元|さんげん|1st January; New Year's Day
三元|さんげん|ternary
電子タバコ|でんしタバコ|electronic cigarette; e-cigarette
電子たばこ|でんしたばこ|electronic cigarette; e-cigarette
電子煙草|でんしたばこ|electronic cigarette; e-cigarette
ペーパーカッター||paper cutter; paper trimmer
ペーパー・カッター||paper cutter; paper trimmer
槓杆|こうかん|lever
槓桿|こうかん|lever
行末|ぎょうまつ|end of a line (of writing); line break
とっといて||save me some; put some aside for me
気が軽い|きがかるい|light-hearted; carefree
黒髭|くろひげ|black beard
黒髭|くろひげ|type of noh mask with a black beard and protruding chin
引っ掻き反射|ひっかきはんしゃ|scratch reflex
ひっかき反射|ひっかきはんしゃ|scratch reflex
引っ掻き硬さ|ひっかきかたさ|scratch hardness
ひっかき硬さ|ひっかきかたさ|scratch hardness
故実読み|こじつよみ|historic customary reading of a kanji word
腱板疎部|けんばんそぶ|rotator interval; rotator cuff interval
ずっぷり||completely submerged (e.g. in water)
ずっぷり||completely soaked (e.g. with rain)
指切拳万、嘘ついたら針千本呑ます|ゆびきりげんまん、うそついたらはりせんぼんのます|Finger cut-off, ten thousand fist-punches, whoever lies has to swallow a thousand needles; words said when making a pinky swear
日常語|にちじょうご|everyday language; common parlance; vernacular
古人類学|こじんるいがく|paleoanthropology
語中|ごちゅう|middle of a word
語中|ごちゅう|within a word
弧状列島|こじょうれっとう|island arc; crescent-shaped archipelago
年半|としなか|middle of a year
年中|としなか|middle of a year
島弧|とうこ|island arc; crescent-shaped archipelago