亜|ア|sub-
哀|アイ、あわ-れ、あわ-れむ|pathetic
挨|アイ|push open
愛|アイ|love
曖|アイ|not clear
悪|アク、オ、わる-い|bad
握|アク、にぎ-る|grip
圧|アツ|pressure
扱|あつか-う|handle
宛|あ-てる|allocate
嵐|あらし|storm
安|アン、やす-い|cheap
案|アン|plan
暗|アン、くら-い|dark
以|イ|by means of
衣|イ、ころも|clothes
位|イ、くらい|rank
囲|イ、かこ-む、かこ-う|surround
医|イ|medicine
依|イ、（エ）|reliant
委|イ、ゆだ-ねる|committee
威|イ|intimidate
為|イ|do
畏|イ、おそ-れる|fear
胃|イ|stomach
尉|イ|military officer
異|イ、こと|uncommon
移|イ、うつ-る、うつ-す|shift
萎|イ、な-える|wither
偉|イ、えら-い|admirable
椅|イ|chair
彙|イ|same kind
意|イ|idea
違|イ、ちが-う、ちが-える|differ
維|イ|fiber
慰|イ、なぐさ-める、なぐさ-む|consolation
遺|イ、（ユイ）|bequeath
緯|イ|horizontal
域|イキ|range
育|イク、そだ-つ、そだ-てる、はぐく-む|nurture
一|イチ、イツ、ひと、ひと-つ|one
壱|イチ|one (falsification prevention)
逸|イツ|deviate
茨|（いばら）[6]|thorn
芋|いも|potato
引|イン、ひ-く、ひ-ける|pull
印|イン、しるし|mark
因|イン、よ-る|cause
咽|イン|throat
姻|イン|matrimony
員|イン|member
院|イン|institution
淫|イン、みだ-ら|lewdness
陰|イン、かげ、かげ-る|shade
飲|イン、の-む|drink
隠|イン、かく-す、かく-れる|conceal
韻|イン|rhyme
右|ウ、ユウ、みぎ|right (direction)
宇|ウ|eaves
羽|ウ、は、はね|feather
雨|ウ、あめ、（あま）|rain
唄|（うた）|songs with shamisen
鬱|ウツ|gloom
畝|うね|furrow
浦|うら|bay
運|ウン、はこ-ぶ|carry
雲|ウン、くも|cloud
永|エイ、なが-い|eternity
泳|エイ、およ-ぐ|swim
英|エイ|England
映|エイ、うつ-る、うつ-す、は-える|reflect
栄|エイ、さか-える、は-え、は-える|prosperity
営|エイ、いとな-む|manage
詠|エイ、よ-む|recitation
影|エイ、かげ|shadow
鋭|エイ、するど-い|pointed
衛|エイ|defense
易|エキ、イ、やさ-しい|easy
疫|エキ、（ヤク）|epidemic
益|エキ、（ヤク）|benefit
液|エキ|fluid
駅|エキ|station
悦|エツ|ecstasy
越|エツ、こ-す、こ-える|cross over
謁|エツ|audience
閲|エツ|review
円|エン、まる-い|round, yen
延|エン、の-びる、の-べる、の-ばす|prolong
沿|エン、そ-う|run alongside
炎|エン、ほのお|inflammation
怨|エン、オン|grudge
宴|エン|banquet
媛|エン|princess
援|エン|aid
園|エン、その|garden
煙|エン、けむ-る、けむり、けむ-い|smoke
猿|エン、さる|monkey
遠|エン、（オン）、とお-い|far
鉛|エン、なまり|lead
塩|エン、しお|salt
演|エン|perform
縁|エン、ふち|affinity
艶|エン、つや|glossy
汚|オ、けが-す、けが-れる、けが-らわしい、よご-す、よご-れる、きたな-い|dirty
王|オウ|king
凹|オウ|concave
央|オウ|center
応|オウ、こた-える|respond
往|オウ|outward journey
押|オウ、お-す、お-さえる|push
旺|オウ|flourishing
欧|オウ|Europe
殴|オウ、なぐ-る|assault
桜|オウ、さくら|cherry tree
翁|オウ|venerable old man
奥|オウ、おく|heart
横|オウ、よこ|side
岡|（おか）[6]|hill
屋|オク、や|roof
億|オク|hundred million
憶|オク|recollection
臆|オク|timidity
虞|おそれ|uneasiness
乙|オツ|the latter
俺|おれ|I, we
卸|おろ-す、おろし|wholesale
音|オン、イン、おと、ね|sound
恩|オン|grace
温|オン、あたた-か、あたた-かい、あたた-まる、あたた-める|warm
穏|オン、おだ-やか|calm
下|カ、ゲ、した、しも、もと、さ-げる、さ-がる、くだ-る、くだ-す、くだ-さる、お-ろす、お-りる|below
化|カ、ケ、ば-ける、ば-かす|change
火|カ、ひ、（ほ）|fire
加|カ、くわ-える、くわ-わる|add
可|カ|possible
仮|カ、（ケ）、かり|temporary
何|カ、なに、（なん）|what
花|カ、はな|flower
佳|カ|excellent
価|カ、あたい|value
果|カ、は-たす、は-てる、は-て|fruit
河|カ、かわ|river
苛|カ|torment
科|カ|section
架|カ、か-ける、か-かる|rack
夏|カ、（ゲ）、なつ|summer
家|カ、ケ、いえ、や|house
荷|カ、に|luggage
華|カ、（ケ）、はな|splendor
菓|カ|confectionery
貨|カ|freight
渦|カ、うず|whirlpool
過|カ、す-ぎる、す-ごす、あやま-つ、あやま-ち|go beyond
嫁|カ、よめ、とつ-ぐ|marry into
暇|カ、ひま|spare time
禍|カ|calamity
靴|カ、くつ|shoes
寡|カ|widow
歌|カ、うた、うた-う|song
箇|カ|counters for things
稼|カ、かせ-ぐ|earnings
課|カ|section
蚊|か|mosquito
牙|ガ、（ゲ）、きば|tusk
瓦|ガ、かわら|tile
我|ガ、われ、わ|ego
画|ガ、カク|tableau
芽|ガ、め|bud
賀|ガ|congratulations
雅|ガ|gracious
餓|ガ|starve
介|カイ|jammed in
回|カイ、（エ）、まわ-る、まわ-す|times
灰|カイ、はい|ashes
会|カイ、エ、あ-う|association
快|カイ、こころよ-い|cheerful
戒|カイ、いまし-める|commandment
改|カイ、あらた-める、あらた-まる|reformation
怪|カイ、あや-しい、あや-しむ|suspicious
拐|カイ|kidnap
悔|カイ、く-いる、く-やむ、くや-しい|repent
海|カイ、うみ|sea
界|カイ|world
皆|カイ、みな|all
械|カイ|contraption
絵|カイ、エ|picture
開|カイ、ひら-く、ひら-ける、あ-く、あ-ける|open
階|カイ|floor of a building
塊|カイ、かたまり|clod
楷|カイ|square character style
解|カイ、ゲ、と-く、と-かす、と-ける|untie
潰|カイ、つぶ-す、つぶ-れる|crush
壊|カイ、こわ-す、こわ-れる|demolition
懐|カイ、ふところ、なつ-かしい、なつ-かしむ、なつ-く、なつ-ける|pocket
諧|カイ|harmony
貝|かい|shellfish
外|ガイ、ゲ、そと、ほか、はず-す、はず-れる|outside
劾|ガイ|censure
害|ガイ|harm
崖|ガイ、がけ|cliff
涯|ガイ|horizon
街|ガイ、（カイ）、まち|street
慨|ガイ|rue
蓋|ガイ、ふた|cover
該|ガイ|above-stated
概|ガイ|outline
骸|ガイ|dead remains
垣|かき|hedge
柿|かき|persimmon
各|カク、おのおの|each
角|カク、かど、つの|angle
拡|カク|broaden
革|カク、かわ|leather
格|カク、（コウ）|status
核|カク|nucleus
殻|カク、から|husk
郭|カク|enclosure
覚|カク、おぼ-える、さ-ます、さ-める|memorize
較|カク|contrast
隔|カク、へだ-てる、へだ-たる|isolate
閣|カク|tall
確|カク、たし-か、たし-かめる|certain
獲|カク、え-る|seize
嚇|カク|menacing
穫|カク|harvest
学|ガク、まな-ぶ|study
岳|ガク、たけ|point
楽|ガク、ラク、たの-しい、たの-しむ|pleasure
額|ガク、ひたい|amount
顎|ガク、あご|jaw
掛|か-ける、か-かる、かかり|hang
潟|かた|lagoon
括|カツ|fasten
活|カツ|active
喝|カツ|hoarse
渇|カツ、かわ-く|thirst
割|カツ、わ-る、わり、わ-れる、さ-く|divide
葛|カツ、くず|arrowroot
滑|カツ、コツ、すべ-る、なめ-らか|slippery
褐|カツ|brown
轄|カツ|control
且|か-つ|moreover
株|かぶ|stocks
釜|かま|kettle
鎌|かま|sickle
刈|か-る|reap
干|カン、ほ-す、ひ-る|dry
刊|カン|publish
甘|カン、あま-い、あま-える、あま-やかす|sweet
汗|カン、あせ|sweat
缶|カン|tin can
完|カン|perfect
肝|カン、きも|liver
官|カン|government official
冠|カン、かんむり|crown
巻|カン、ま-く、まき|scroll
看|カン|watch over
陥|カン、おちい-る、おとしい-れる|collapse
乾|カン、かわ-く、かわ-かす|dry
勘|カン|intuition
患|カン、わずら-う|afflicted
貫|カン、つらぬ-く|pierce
寒|カン、さむ-い|cold
喚|カン|yell
堪|カン、た-える|withstand
換|カン、か-える、か-わる|interchange
敢|カン|daring
棺|カン|coffin
款|カン|goodwill
間|カン、ケン、あいだ、ま|interval
閑|カン|leisure
勧|カン、すす-める|persuade
寛|カン|tolerant
幹|カン、みき|tree-trunk
感|カン|feeling
漢|カン|China
慣|カン、な-れる、な-らす|accustomed
管|カン、くだ|pipe
関|カン、せき、かか-わる|related
歓|カン|delight
監|カン|oversee
緩|カン、ゆる-い、ゆる-やか、ゆる-む、ゆる-める|slacken
憾|カン|remorse
還|カン|send back
館|カン、やかた|public building
環|カン|ring
簡|カン|simplicity
観|カン|observe
韓|カン|Korea
艦|カン|warship
鑑|カン、かんが-みる|specimen
丸|ガン、まる、まる-い、まる-める|circle
含|ガン、ふく-む、ふく-める|include
岸|ガン、きし|beach
岩|ガン、いわ|boulder
玩|ガン|trifle with
眼|ガン、（ゲン）、まなこ|eyeball
頑|ガン|stubborn
顔|ガン、かお|face
願|ガン、ねが-う|request
企|キ、くわだ-てる|plan
伎|キ|deed
危|キ、あぶ-ない、あや-うい、あや-ぶむ|dangerous
机|キ、つくえ|desk
気|キ、ケ|feeling
岐|キ|branch off
希|キ|hope
忌|キ、い-む、い-まわしい|mourning
汽|キ|steam
奇|キ|strange
祈|キ、いの-る|pray
季|キ|seasons
紀|キ|chronicle
軌|キ|rut
既|キ、すで-に|previously
記|キ、しる-す|write down
起|キ、お-きる、お-こる、お-こす|wake up
飢|キ、う-える|hungry
鬼|キ、おに|ghost
帰|キ、かえ-る、かえ-す|return
基|キ、もと、もとい|foundation
寄|キ、よ-る、よ-せる|approach
規|キ|rule
亀|キ、かめ|turtle
喜|キ、よろこ-ぶ|rejoice
幾|キ、いく|how many
揮|キ|brandish
期|キ、（ゴ）|period of time
棋|キ|chess piece
貴|キ、たっと-い、とうと-い、たっと-ぶ、とうと-ぶ|precious
棄|キ|abandon
毀|キ|destroy
旗|キ、はた|national flag
器|キ、うつわ|container
畿|キ|capital
輝|キ、かがや-く|radiance
機|キ、はた|machine
騎|キ|equestrian
技|ギ、わざ|skill
宜|ギ|best regards
偽|ギ、いつわ-る、にせ|falsehood
欺|ギ、あざむ-く|deceit
義|ギ|righteousness
疑|ギ、うたが-う|doubt
儀|ギ|ceremony
戯|ギ、たわむ-れる|frolic
擬|ギ|mimic
犠|ギ|sacrifice
議|ギ|deliberation
菊|キク|chrysanthemum
吉|キチ、キツ|good luck
喫|キツ|consume
詰|キツ、つ-める、つ-まる、つ-む|packed
却|キャク|instead
客|キャク、カク|guest
脚|キャク、（キャ）、あし|leg
逆|ギャク、さか、さか-らう|inverted
虐|ギャク、しいた-げる|tyrannize
九|キュウ、ク、ここの、ここの-つ|nine
久|キュウ、（ク）、ひさ-しい|long time
及|キュウ、およ-ぶ、およ-び、およ-ぼす|reach out
弓|キュウ、ゆみ|bow (archery, violin)
丘|キュウ、おか|hill
旧|キュウ|old times
休|キュウ、やす-む、やす-まる、やす-める|rest
吸|キュウ、す-う|suck
朽|キュウ、く-ちる|decay
臼|キュウ、うす|mortar
求|キュウ、もと-める|request
究|キュウ、きわ-める|research
泣|キュウ、な-く|cry
急|キュウ、いそ-ぐ|hurry
級|キュウ|rank
糾|キュウ|twist
宮|キュウ、グウ、（ク）、みや|Shinto shrine
救|キュウ、すく-う|salvation
球|キュウ、たま|sphere
給|キュウ|salary
嗅|キュウ、か-ぐ|smell
窮|キュウ、きわ-める、きわ-まる|hard up
牛|ギュウ、うし|cow
去|キョ、コ、さ-る|leave
巨|キョ|gigantic
居|キョ、い-る|reside
拒|キョ、こば-む|repel
拠|キョ、コ|foothold
挙|キョ、あ-げる、あ-がる|raise
虚|キョ、（コ）|void
許|キョ、ゆる-す|permit
距|キョ|long-distance
魚|ギョ、うお、さかな|fish
御|ギョ、ゴ、おん|honorable
漁|ギョ、リョウ|fishing
凶|キョウ|villain
共|キョウ、とも|together
叫|キョウ、さけ-ぶ|shout
狂|キョウ、くる-う、くる-おしい|lunatic
京|キョウ、ケイ|capital
享|キョウ|receive
供|キョウ、（ク）、そな-える、とも|offer
協|キョウ|cooperation
況|キョウ|condition
峡|キョウ|gorge
挟|キョウ、はさ-む、はさ-まる|pinch
狭|キョウ、せま-い、せば-める、せば-まる|cramped
恐|キョウ、おそ-れる、おそ-ろしい|fear
恭|キョウ、うやうや-しい|respect
胸|キョウ、むね、（むな）|bosom
脅|キョウ、おびや-かす、おど-す、おど-かす|threaten
強|キョウ、ゴウ、つよ-い、つよ-まる、つよ-める、し-いる|strong
教|キョウ、おし-える、おそ-わる|teach
郷|キョウ、ゴウ|home town
境|キョウ、（ケイ）、さかい|boundary
橋|キョウ、はし|bridge
矯|キョウ、た-める|rectify
鏡|キョウ、かがみ|mirror
競|キョウ、ケイ、きそ-う、せ-る|compete
響|キョウ、ひび-く|echo
驚|キョウ、おどろ-く、おどろ-かす|wonder
仰|ギョウ、（コウ）、あお-ぐ、おお-せ|face-up
暁|ギョウ、あかつき|daybreak
業|ギョウ、ゴウ、わざ|business
凝|ギョウ、こ-る、こ-らす|congeal
曲|キョク、ま-がる、ま-げる|musical composition
局|キョク|office
極|キョク、ゴク、きわ-める、きわ-まる、きわ-み|poles
玉|ギョク、たま|ball
巾|キン|towel
斤|キン|axe
均|キン|level
近|キン、ちか-い|near
金|キン、コン、かね、（かな）|gold
菌|キン|germ
勤|キン、（ゴン）、つと-める、つと-まる|diligence
琴|キン、こと|harp
筋|キン、すじ|muscle
僅|キン、わず-か|a wee bit
禁|キン|prohibition
緊|キン|tense
錦|キン、にしき|brocade
謹|キン、つつし-む|discreet
襟|キン、えり|collar
吟|ギン|versify
銀|ギン|silver
区|ク|ward
句|ク|phrase
苦|ク、くる-しい、くる-しむ、くる-しめる、にが-い、にが-る|suffer
駆|ク、か-ける、か-る|drive
具|グ|tool
惧|グ|dread
愚|グ、おろ-か|foolish
空|クウ、そら、あ-く、あ-ける、から|sky
偶|グウ|accidentally
遇|グウ|interview
隅|グウ、すみ|corner
串|くし|skewer
屈|クツ|yield
掘|クツ、ほ-る|dig
窟|クツ|cavern
熊|くま|bear
繰|く-る|winding
君|クン、きみ|you
訓|クン|instruction
勲|クン|meritorious deed
薫|クン、かお-る|fragrant
軍|グン|army
郡|グン|county
群|グン、む-れる、む-れ、（むら）|flock
兄|ケイ、（キョウ）、あに|older brother
刑|ケイ|punish
形|ケイ、ギョウ、かた、かたち|shape
系|ケイ|lineage
径|ケイ|diameter
茎|ケイ、くき|stalk
係|ケイ、かか-る、かかり|person in charge
型|ケイ、かた|model
契|ケイ、ちぎ-る|pledge
計|ケイ、はか-る、はか-らう|measure
恵|ケイ、エ、めぐ-む|favor
啓|ケイ|disclose
掲|ケイ、かか-げる|put up (a notice)
渓|ケイ|mountain stream
経|ケイ、キョウ、へ-る|manage
蛍|ケイ、ほたる|lightning-bug
敬|ケイ、うやま-う|respect
景|ケイ|scenery
軽|ケイ、かる-い、かろ-やか|light
傾|ケイ、かたむ-く、かたむ-ける|lean
携|ケイ、たずさ-える、たずさ-わる|portable
継|ケイ、つ-ぐ|inherit
詣|ケイ、もう-でる|visit a temple
慶|ケイ|jubilation
憬|ケイ|long for
稽|ケイ|consider
憩|ケイ、いこ-い、いこ-う|recess
警|ケイ|guard against
鶏|ケイ、にわとり|chicken
芸|ゲイ|art
迎|ゲイ、むか-える|welcome
鯨|ゲイ、くじら|whale
隙|ゲキ、すき|fissure
劇|ゲキ|drama
撃|ゲキ、う-つ|beat
激|ゲキ、はげ-しい|violent
桁|けた|beam
欠|ケツ、か-ける、か-く|lack
穴|ケツ、あな|hole
血|ケツ、ち|blood
決|ケツ、き-める、き-まる|decide
結|ケツ、むす-ぶ、ゆ-う、ゆ-わえる|tie
傑|ケツ|greatness
潔|ケツ、いさぎよ-い|undefiled
月|ゲツ、ガツ、つき|month, moon
犬|ケン、いぬ|dog
件|ケン|affair
見|ケン、み-る、み-える、み-せる|see
券|ケン|ticket
肩|ケン、かた|shoulder
建|ケン、（コン）、た-てる、た-つ|build
研|ケン、と-ぐ|sharpen
県|ケン|prefecture
倹|ケン|frugal
兼|ケン、か-ねる|concurrently
剣|ケン、つるぎ|sabre
拳|ケン、こぶし|fist
軒|ケン、のき|flats
健|ケン、すこ-やか|healthy
険|ケン、けわ-しい|precipitous
圏|ケン|sphere
堅|ケン、かた-い|strict
検|ケン|examine
嫌|ケン、（ゲン）、きら-う、いや|dislike
献|ケン、（コン）|offering
絹|ケン、きぬ|silk
遣|ケン、つか-う、つか-わす|dispatch
権|ケン、（ゴン）|rights
憲|ケン|constitution
賢|ケン、かしこ-い|intelligent
謙|ケン|self-effacing
鍵|ケン、かぎ|key
繭|ケン、まゆ|cocoon
顕|ケン|appear
験|ケン、（ゲン）|test
懸|ケン、（ケ）、か-ける、か-かる|suspend
元|ゲン、ガン、もと|origin
幻|ゲン、まぼろし|phantasm
玄|ゲン|mysterious
言|ゲン、ゴン、い-う、こと|say
弦|ゲン、つる|bowstring
限|ゲン、かぎ-る|limit
原|ゲン、はら|field
現|ゲン、あらわ-れる、あらわ-す|appear
舷|ゲン|gunwale
減|ゲン、へ-る、へ-らす|decrease
源|ゲン、みなもと|origin
厳|ゲン、（ゴン）、おごそ-か、きび-しい|strict
己|コ、キ、おのれ|self
戸|コ、と|door
古|コ、ふる-い、ふる-す|old
呼|コ、よ-ぶ|call
固|コ、かた-める、かた-まる、かた-い|hard
股|コ、また|crotch
虎|コ、とら|tiger
孤|コ|orphan
弧|コ|arc
故|コ、ゆえ|circumstances
枯|コ、か-れる、か-らす|wither
個|コ|individual
庫|コ、（ク）|warehouse
湖|コ、みずうみ|lake
雇|コ、やと-う|employ
誇|コ、ほこ-る|boast
鼓|コ、つづみ|drum
錮|コ|tie up
顧|コ、かえり-みる|look back
五|ゴ、いつ、いつ-つ|five
互|ゴ、たが-い|mutually
午|ゴ|noon
呉|ゴ|give
後|ゴ、コウ、のち、うし-ろ、あと、おく-れる|behind
娯|ゴ|recreation
悟|ゴ、さと-る|enlightenment
碁|ゴ|Go
語|ゴ、かた-る、かた-らう|language
誤|ゴ、あやま-る|mistake
護|ゴ|safeguard
口|コウ、ク、くち|mouth
工|コウ、ク|craft
公|コウ、おおやけ|public
勾|コウ|capture
孔|コウ|cavity
功|コウ、（ク）|achievement
巧|コウ、たく-み|adroit
広|コウ、ひろ-い、ひろ-まる、ひろ-める、ひろ-がる、ひろ-げる|wide
甲|コウ、カン|armor
交|コウ、まじ-わる、まじ-える、ま-じる、ま-ざる、ま-ぜる、か-う、か-わす|mix
光|コウ、ひか-る、ひかり|ray
向|コウ、む-く、む-ける、む-かう、む-こう|over there
后|コウ|empress
好|コウ、この-む、す-く|like
江|コウ、え|inlet
考|コウ、かんが-える|think
行|コウ、ギョウ、（アン）、い-く、ゆ-く、おこな-う|go
坑|コウ|pit
孝|コウ|filial piety
抗|コウ|confront
攻|コウ、せ-める|aggression
更|コウ、さら、ふ-ける、ふ-かす|grow late
効|コウ、き-く|effect
幸|コウ、さいわ-い、さち、しあわ-せ|happiness
拘|コウ|arrest
肯|コウ|agreement
侯|コウ|marquis
厚|コウ、あつ-い|thick
恒|コウ|constancy
洪|コウ|deluge
皇|コウ、オウ|emperor
紅|コウ、（ク）、べに、くれない|deep red
荒|コウ、あら-い、あ-れる、あ-らす|laid waste
郊|コウ|outskirts
香|コウ、（キョウ）、か、かお-り、かお-る|incense
候|コウ、そうろう|climate
校|コウ|school
耕|コウ、たがや-す|till
航|コウ|cruise
貢|コウ、（ク）、みつ-ぐ|tribute
降|コウ、お-りる、お-ろす、ふ-る|descend
高|コウ、たか-い、たか、たか-まる、たか-める|tall, expensive
康|コウ|health
控|コウ、ひか-える|withdraw
梗|コウ|close up
黄|コウ、オウ、き、（こ）|yellow
喉|コウ、のど|throat
慌|コウ、あわ-てる、あわ-ただしい|disconcerted
港|コウ、みなと|harbor
硬|コウ、かた-い|stiff
絞|コウ、しぼ-る、し-める、し-まる|strangle
項|コウ|paragraph
溝|コウ、みぞ|gutter
鉱|コウ|mineral
構|コウ、かま-える、かま-う|construct
綱|コウ、つな|hawser
酵|コウ|fermentation
稿|コウ|draft
興|コウ、キョウ、おこ-る、おこ-す|entertain
衡|コウ|equilibrium
鋼|コウ、はがね|steel
講|コウ|lecture
購|コウ|subscription
乞|こ-う|beg
号|ゴウ|number
合|ゴウ、ガッ、（カッ）、あ-う、あ-わす、あ-わせる|fit
拷|ゴウ|torture
剛|ゴウ|sturdy
傲|ゴウ|be proud
豪|ゴウ|overpowering
克|コク|overcome
告|コク、つ-げる|tell
谷|コク、たに|valley
刻|コク、きざ-む|engrave
国|コク、くに|country
黒|コク、くろ、くろ-い|black
穀|コク|cereals
酷|コク|cruel
獄|ゴク|prison
骨|コツ、ほね|bone
駒|こま|horse
込|こ-む、こ-める|crowded
頃|ころ|times
今|コン、キン、いま|now
困|コン、こま-る|become distressed
昆|コン|descendants
恨|コン、うら-む、うら-めしい|rancor
根|コン、ね|root
婚|コン|marriage
混|コン、ま-じる、ま-ざる、ま-ぜる、こ-む|mix
痕|コン、あと|mark
紺|コン|dark blue
魂|コン、たましい|soul
墾|コン|ground-breaking
懇|コン、ねんご-ろ|sociable
左|サ、ひだり|left (direction)
佐|サ|help
沙|サ|sand
査|サ|investigate
砂|サ、シャ、すな|sand
唆|サ、そそのか-す|tempt
差|サ、さ-す|distinction
詐|サ|lie
鎖|サ、くさり|chain
座|ザ、すわ-る|sit
挫|ザ|sprain
才|サイ|genius
再|サイ、（サ）、ふたた-び|again
災|サイ、わざわ-い|disaster
妻|サイ、つま|wife
采|サイ|form
砕|サイ、くだ-く、くだ-ける|smash
宰|サイ|superintend
栽|サイ|plantation
彩|サイ、いろど-る|coloring
採|サイ、と-る|pick
済|サイ、す-む、す-ます|settle
祭|サイ、まつ-る、まつ-り|festival
斎|サイ|purification
細|サイ、ほそ-い、ほそ-る、こま-か、こま-かい|thin
菜|サイ、な|vegetable
最|サイ、もっと-も|most
裁|サイ、た-つ、さば-く|judge
債|サイ|bond
催|サイ、もよお-す|sponsor
塞|サイ、ソク、ふさ-ぐ、ふさ-がる|obstruct
歳|サイ、（セイ）|year-end
載|サイ、の-せる、の-る|ride
際|サイ、きわ|occasion
埼|（さい）[6]|cape (geography)
在|ザイ、あ-る|exist
材|ザイ|lumber
剤|ザイ|dose
財|ザイ、（サイ）|wealth
罪|ザイ、つみ|guilt
崎|さき|promontory
作|サク、サ、つく-る|make
削|サク、けず-る|plane
昨|サク|previous
柵|サク|fence
索|サク|cord
策|サク|scheme
酢|サク、す|vinegar
搾|サク、しぼ-る|squeeze
錯|サク|confused
咲|さ-く|blossom
冊|サツ、サク|counter for books
札|サツ、ふだ|tag
刷|サツ、す-る|printing
刹|サツ、セツ|temple
拶|サツ|be imminent
殺|サツ、（サイ）、（セツ）、ころ-す|kill
察|サツ|guess
撮|サツ、と-る|snapshot
擦|サツ、す-る、す-れる|grate
雑|ザツ、ゾウ|miscellaneous
皿|さら|dish
三|サン、み、み-つ、みっ-つ|three
山|サン、やま|mountain
参|サン、まい-る|participate
桟|サン|scaffold
蚕|サン、かいこ|silkworm
惨|サン、ザン、みじ-め|wretched
産|サン、う-む、う-まれる、うぶ|give birth
傘|サン、かさ|umbrella
散|サン、ち-る、ち-らす、ち-らかす、ち-らかる|scatter
算|サン|calculate
酸|サン、す-い|acid
賛|サン|approve
残|ザン、のこ-る、のこ-す|remainder
斬|ザン、き-る|kill by slicing
暫|ザン|temporarily
士|シ|gentleman
子|シ、ス、こ|child
支|シ、ささ-える|branch
止|シ、と-まる、と-める|stop
氏|シ、うじ|family name
仕|シ、（ジ）、つか-える|do
史|シ|history
司|シ|director
四|シ、よ、よ-つ、よっ-つ、よん|four
市|シ、いち|market
矢|シ、や|arrow
旨|シ、むね|delicious
死|シ、し-ぬ|death
糸|シ、いと|thread
至|シ、いた-る|climax
伺|シ、うかが-う|pay respects
志|シ、こころざ-す、こころざし|intention
私|シ、わたくし、わたし|me
使|シ、つか-う|use
刺|シ、さ-す、さ-さる|thorn
始|シ、はじ-める、はじ-まる|begin
姉|シ、あね|older sister
枝|シ、えだ|branch
祉|シ|welfare
肢|シ|limb
姿|シ、すがた|figure
思|シ、おも-う|think
指|シ、ゆび、さ-す|finger
施|シ、セ、ほどこ-す|carry out
師|シ|expert
恣|シ|selfish
紙|シ、かみ|paper
脂|シ、あぶら|fat
視|シ|look at
紫|シ、むらさき|purple
詞|シ|poetry
歯|シ、は|tooth
嗣|シ|heir
試|シ、こころ-みる、ため-す|test
詩|シ|poem
資|シ|resources
飼|シ、か-う|domesticate
誌|シ|document
雌|シ、め、めす|feminine
摯|シ|seriousness
賜|シ、たまわ-る|grant
諮|シ、はか-る|consult with
示|ジ、シ、しめ-す|indicate
字|ジ、あざ|letter
寺|ジ、てら|Buddhist temple
次|ジ、シ、つ-ぐ、つぎ|next
耳|ジ、みみ|ear
自|ジ、シ、みずか-ら|oneself
似|ジ、に-る|becoming
児|ジ、（ニ）|child
事|ジ、（ズ）、こと|abstract thing
侍|ジ、さむらい|waiter
治|ジ、チ、おさ-める、おさ-まる、なお-る、なお-す|govern
持|ジ、も-つ|hold
時|ジ、とき|time
滋|ジ|nourishing
慈|ジ、いつく-しむ|mercy
辞|ジ、や-める|resign
磁|ジ|magnet
餌|ジ、えさ、え|bait
璽|ジ|emperor's seal
鹿|しか、（か）、ロク|deer
式|シキ|style
識|シキ|discriminating
軸|ジク|axis
七|シチ、なな、なな-つ、（なの）|seven
𠮟|シツ、しか-る|scold
失|シツ、うしな-う|lose
室|シツ、むろ|room
疾|シツ|rapidly
執|シツ、シュウ、と-る|tenacious
湿|シツ、しめ-る、しめ-す|damp
嫉|シツ|envy
漆|シツ、うるし|lacquer
質|シツ、シチ、（チ）|quality
実|ジツ、み、みの-る|truth
芝|しば|turf
写|シャ、うつ-す、うつ-る|copy
社|シャ、やしろ|company
車|シャ、くるま|car
舎|シャ|cottage
者|シャ、もの|someone
射|シャ、い-る|shoot
捨|シャ、す-てる|throw away
赦|シャ|pardon
斜|シャ、なな-め|diagonal
煮|シャ、に-る、に-える、に-やす|boil
遮|シャ、さえぎ-る|intercept
謝|シャ、あやま-る|apologize
邪|ジャ|wicked
蛇|ジャ、ダ、へび|snake
尺|シャク|shaku
借|シャク、か-りる|borrow
酌|シャク、く-む|bartending
釈|シャク|explanation
爵|シャク|baron
若|ジャク、（ニャク）、わか-い、も-しくは|young
弱|ジャク、よわ-い、よわ-る、よわ-まる、よわ-める|weak
寂|ジャク、（セキ）、さび、さび-しい、さび-れる|loneliness
手|シュ、て、（た）|hand
主|シュ、（ス）、ぬし、おも|master
守|シュ、（ス）、まも-る、も-り|protect
朱|シュ|vermilion
取|シュ、と-る|take
狩|シュ、か-る、か-り|hunt
首|シュ、くび|neck
殊|シュ、こと|particularly
珠|シュ|pearl
酒|シュ、さけ、（さか）|alcoholic drink
腫|シュ、は-れる、は-らす|tumor
種|シュ、たね|kind
趣|シュ、おもむき|gist
寿|ジュ、ことぶき|longevity
受|ジュ、う-ける、う-かる|accept
呪|ジュ、のろ-う|curse
授|ジュ、さず-ける、さず-かる|instruct
需|ジュ|demand
儒|ジュ|Confucian
樹|ジュ|trees
収|シュウ、おさ-める、おさ-まる|take in
囚|シュウ|captured
州|シュウ、す|state
舟|シュウ、ふね、（ふな）|boat
秀|シュウ、ひい-でる|excel
周|シュウ、まわ-り|circumference
宗|シュウ、ソウ|religion
拾|シュウ、ジュウ、ひろ-う|pick up
秋|シュウ、あき|autumn
臭|シュウ、くさ-い、にお-う|stinking
修|シュウ、（シュ）、おさ-める、おさ-まる|discipline
袖|シュウ、そで|sleeve
終|シュウ、お-わる、お-える|end
羞|シュウ|feel ashamed
習|シュウ、なら-う|learn
週|シュウ|week
就|シュウ、（ジュ）、つ-く、つ-ける|concerning
衆|シュウ、（シュ）|masses
集|シュウ、あつ-まる、あつ-める、つど-う|collect
愁|シュウ、うれ-える、うれ-い|distress
酬|シュウ|repay
醜|シュウ、みにく-い|ugly
蹴|シュウ、け-る|kick
襲|シュウ、おそ-う|attack
十|ジュウ、ジッ、とお、と|ten
汁|ジュウ、しる|soup
充|ジュウ、あ-てる|allot
住|ジュウ、す-む、す-まう|dwelling
柔|ジュウ、ニュウ、やわ-らか、やわ-らかい|tender
重|ジュウ、チョウ、え、おも-い、かさ-ねる、かさ-なる|heavy
従|ジュウ、（ショウ）、（ジュ）、したが-う、したが-える|obey
渋|ジュウ、しぶ、しぶ-い、しぶ-る|astringent
銃|ジュウ|gun
獣|ジュウ、けもの|animal
縦|ジュウ、たて|vertical
叔|シュク|uncle
祝|シュク、（シュウ）、いわ-う|celebrate
宿|シュク、やど、やど-る、やど-す|inn
淑|シュク|graceful
粛|シュク|solemn
縮|シュク、ちぢ-む、ちぢ-まる、ちぢ-める、ちぢ-れる、ちぢ-らす|shrink
塾|ジュク|cram school
熟|ジュク、う-れる|ripen
出|シュツ、（スイ）、で-る、だ-す|exit
述|ジュツ、の-べる|mention
術|ジュツ|art
俊|シュン|genius
春|シュン、はる|springtime
瞬|シュン、またた-く|wink
旬|ジュン、（シュン）|10-day period (of the month)
巡|ジュン、めぐ-る|patrol
盾|ジュン、たて|shield
准|ジュン|quasi-
殉|ジュン|martyrdom
純|ジュン|genuine
循|ジュン|sequential
順|ジュン|obey
準|ジュン|standard
潤|ジュン、うるお-う、うるお-す、うる-む|wet
遵|ジュン|abide by
処|ショ|dispose
初|ショ、はじ-め、はじ-めて、はつ、うい、そ-める|first
所|ショ、ところ|place
書|ショ、か-く|write
庶|ショ|commoner
暑|ショ、あつ-い|hot
署|ショ|government office
緒|ショ、（チョ）、お|thong
諸|ショ|various
女|ジョ、ニョ、（ニョウ）、おんな、め|woman
如|ジョ、ニョ|likeness
助|ジョ、たす-ける、たす-かる、すけ|help
序|ジョ|preface
叙|ジョ|confer
徐|ジョ|gradually
除|ジョ、（ジ）、のぞ-く|exclude
小|ショウ、ちい-さい、こ、お|small
升|ショウ、ます|measuring box
少|ショウ、すく-ない、すこ-し|few
召|ショウ、め-す|summon
匠|ショウ|artisan
床|ショウ、とこ、ゆか|bed
抄|ショウ|extract
肖|ショウ|resemblance
尚|ショウ|esteem
招|ショウ、まね-く|beckon
承|ショウ、うけたまわ-る|acquiesce
昇|ショウ、のぼ-る|rise up
松|ショウ、まつ|pine
沼|ショウ、ぬま|marsh
昭|ショウ|shining
宵|ショウ、よい|wee hours
将|ショウ|leader
消|ショウ、き-える、け-す|extinguish
症|ショウ|symptoms
祥|ショウ|auspicious
称|ショウ|appellation
笑|ショウ、わら-う、え-む|laugh
唱|ショウ、とな-える|chant
商|ショウ、あきな-う|sell
渉|ショウ|ford
章|ショウ|chapter
紹|ショウ|introduce
訟|ショウ|sue
勝|ショウ、か-つ、まさ-る|win
掌|ショウ|manipulate
晶|ショウ|sparkle
焼|ショウ、や-く、や-ける|bake
焦|ショウ、こ-げる、こ-がす、こ-がれる、あせ-る|char
硝|ショウ|nitrate
粧|ショウ|cosmetics
詔|ショウ、みことのり|imperial edict
証|ショウ|evidence
象|ショウ、ゾウ|elephant
傷|ショウ、きず、いた-む、いた-める|wound
奨|ショウ|exhort
照|ショウ、て-る、て-らす、て-れる|illuminate
詳|ショウ、くわ-しい|detailed
彰|ショウ|patent
障|ショウ、さわ-る|hurt
憧|ショウ、あこが-れる|desire
衝|ショウ|collide
賞|ショウ|prize
償|ショウ、つぐな-う|reparation
礁|ショウ|reef
鐘|ショウ、かね|bell
上|ジョウ、（ショウ）、うえ、（うわ）、かみ、あ-げる、あ-がる、のぼ-る、のぼ-せる、のぼ-す|up
丈|ジョウ、たけ|length
冗|ジョウ|superfluous
条|ジョウ|clause
状|ジョウ|form
乗|ジョウ、の-る、の-せる|ride
城|ジョウ、しろ|castle
浄|ジョウ|clean
剰|ジョウ|surplus
常|ジョウ、つね、とこ|normal
情|ジョウ、（セイ）、なさ-け|feelings
場|ジョウ、ば|place
畳|ジョウ、たた-む、たたみ|tatami mat
蒸|ジョウ、む-す、む-れる、む-らす|steam
縄|ジョウ、なわ|straw rope
壌|ジョウ|lot
嬢|ジョウ|lass
錠|ジョウ|lock
譲|ジョウ、ゆず-る|defer
醸|ジョウ、かも-す|brew
色|ショク、シキ、いろ|color
拭|ショク、ふ-く、ぬぐ-う|wipe
食|ショク、（ジキ）、く-う、く-らう、た-べる|eat, meal
植|ショク、う-える、う-わる|plant
殖|ショク、ふ-える、ふ-やす|augment
飾|ショク、かざ-る|decorate
触|ショク、ふ-れる、さわ-る|contact
嘱|ショク|entrust
織|ショク、シキ、お-る|weave
職|ショク|employment
辱|ジョク、はずかし-める|embarrass
尻|しり|buttocks
心|シン、こころ|heart
申|シン、もう-す|say
伸|シン、の-びる、の-ばす、の-べる|lengthen
臣|シン、ジン|retainer
芯|シン|core
身|シン、み|body
辛|シン、から-い|spicy
侵|シン、おか-す|encroach
信|シン|trust
津|シン、つ|haven
神|シン、ジン、かみ、（かん）、（こう）|god
唇|シン、くちびる|lips
娠|シン|with child
振|シン、ふ-る、ふ-るう、ふ-れる|shake
浸|シン、ひた-す、ひた-る|immersed
真|シン、ま|true
針|シン、はり|needle
深|シン、ふか-い、ふか-まる、ふか-める|deep
紳|シン|sire
進|シン、すす-む、すす-める|advance
森|シン、もり|forest
診|シン、み-る|checkup
寝|シン、ね-る、ね-かす|lie down
慎|シン、つつし-む|humility
新|シン、あたら-しい、あら-た、にい|new
審|シン|examine
震|シン、ふる-う、ふる-える|quake
薪|シン、たきぎ|fuel
親|シン、おや、した-しい、した-しむ|parent
人|ジン、ニン、ひと|person
刃|ジン、は|blade
仁|ジン、（ニ）|humanity
尽|ジン、つ-くす、つ-きる、つ-かす|exhaust
迅|ジン|swift
甚|ジン、はなは-だ、はなは-だしい|tremendously
陣|ジン|camp
尋|ジン、たず-ねる|inquire
腎|ジン|kidney
須|ス|by all means
図|ズ、ト、はか-る|diagram
水|スイ、みず|water
吹|スイ、ふ-く|blow
垂|スイ、た-れる、た-らす|droop
炊|スイ、た-く|cook
帥|スイ|commander
粋|スイ、いき|chic
衰|スイ、おとろ-える|decline
推|スイ、お-す|infer
酔|スイ、よ-う|drunk
遂|スイ、と-げる|consummate
睡|スイ|drowsy
穂|スイ、ほ|ear
随|ズイ|follow
髄|ズイ|marrow
枢|スウ|hinge
崇|スウ|adore
数|スウ、（ス）、かず、かぞ-える|number
据|す-える、す-わる|set
杉|すぎ|cedar
裾|すそ|cuff
寸|スン|measurement
瀬|せ|rapids
是|ゼ|just so
井|セイ、（ショウ）、い|well
世|セイ、セ、よ|world
正|セイ、ショウ、ただ-しい、ただ-す、まさ|correct
生|セイ、ショウ、い-きる、い-かす、い-ける、う-まれる、う-む、お-う、は-える、は-やす、き、なま|life
成|セイ、（ジョウ）、な-る、な-す|become
西|セイ、サイ、にし|west
声|セイ、（ショウ）、こえ、（こわ）|voice
制|セイ|control
姓|セイ、ショウ|surname
征|セイ|subjugate
性|セイ、ショウ|gender
青|セイ、（ショウ）、あお、あお-い|blue
斉|セイ|adjusted
政|セイ、（ショウ）、まつりごと|politics
星|セイ、（ショウ）、ほし|star
牲|セイ|animal sacrifice
省|セイ、ショウ、かえり-みる、はぶ-く|government ministry
凄|セイ|uncanny
逝|セイ、ゆ-く、い-く|departed
清|セイ、（ショウ）、きよ-い、きよ-まる、きよ-める|pure
盛|セイ、（ジョウ）、も-る、さか-る、さか-ん|prosper
婿|セイ、むこ|bridegroom
晴|セイ、は-れる、は-らす|clear up
勢|セイ、いきお-い|power
聖|セイ|holy
誠|セイ、まこと|sincerity
精|セイ、（ショウ）|refined
製|セイ|manufacture
誓|セイ、ちか-う|vow
静|セイ、（ジョウ）、しず、しず-か、しず-まる、しず-める|quiet
請|セイ、（シン）、こ-う、う-ける|solicit
整|セイ、ととの-える、ととの-う|put in order
醒|セイ|be disillusioned
税|ゼイ|tax
夕|セキ、ゆう|evening
斥|セキ|reject
石|セキ、（シャク）、（コク）、いし|stone
赤|セキ、（シャク）、あか、あか-い、あか-らむ、あか-らめる|red
昔|セキ、（シャク）、むかし|long ago
析|セキ|chop
席|セキ|seat
脊|セキ|stature
隻|セキ|vessels
惜|セキ、お-しい、お-しむ|pity
戚|セキ|grieve
責|セキ、せ-める|blame
跡|セキ、あと|tracks
積|セキ、つ-む、つ-もる|accumulate
績|セキ|exploits
籍|セキ|enroll
切|セツ、（サイ）、き-る、き-れる|cut
折|セツ、お-る、おり、お-れる|fold
拙|セツ、つたな-い|bungling
窃|セツ|stealth
接|セツ、つ-ぐ|contact
設|セツ、もう-ける|establish
雪|セツ、ゆき|snow
摂|セツ|vicarious
節|セツ、（セチ）、ふし|node
説|セツ、（ゼイ）、と-く|theory
舌|ゼツ、した|tongue
絶|ゼツ、た-える、た-やす、た-つ|discontinue
千|セン、ち|thousand
川|セン、かわ|river
仙|セン|hermit
占|セン、し-める、うらな-う|fortune telling
先|セン、さき|previous
宣|セン|proclaim
専|セン、もっぱ-ら|specialty
泉|セン、いずみ|spring
浅|セン、あさ-い|shallow
洗|セン、あら-う|wash
染|セン、そ-める、そ-まる、し-みる、し-み|dye
扇|セン、おうぎ|fan
栓|セン|plug
旋|セン|rotation
船|セン、ふね、（ふな）|boat
戦|セン、いくさ、たたか-う|war
煎|セン、い-る|broil
羨|セン、うらや-む、うらや-ましい|envy
腺|セン|gland
詮|セン|discussion
践|セン|tread
箋|セン|paper
銭|セン、ぜに|coin
潜|セン、ひそ-む、もぐ-る|submerge
線|セン|line
遷|セン|transition
選|セン、えら-ぶ|choose
薦|セン、すす-める|recommend
繊|セン|slender
鮮|セン、あざ-やか|fresh
全|ゼン、まった-く、すべ-て|whole
前|ゼン、まえ|in front
善|ゼン、よ-い|good
然|ゼン、ネン|so
禅|ゼン|Zen
漸|ゼン|steadily
膳|ゼン|tray
繕|ゼン、つくろ-う|darning
狙|ソ、ねら-う|aim at
阻|ソ、はば-む|thwart
祖|ソ|ancestor
租|ソ|tariff
素|ソ、ス|elementary
措|ソ|set aside
粗|ソ、あら-い|coarse
組|ソ、く-む、くみ|association
疎|ソ、うと-い、うと-む|alienate
訴|ソ、うった-える|sue
塑|ソ|model
遡|ソ、さかのぼ-る|go upstream
礎|ソ、いしずえ|cornerstone
双|ソウ、ふた|pair
壮|ソウ|robust
早|ソウ、（サッ）、はや-い、はや-まる、はや-める|early
争|ソウ、あらそ-う|conflict
走|ソウ、はし-る|run
奏|ソウ、かな-でる|play music
相|ソウ、ショウ、あい|mutual
荘|ソウ|villa
草|ソウ、くさ|grass
送|ソウ、おく-る|send
倉|ソウ、くら|warehouse
捜|ソウ、さが-す|search
挿|ソウ、さ-す|insert
桑|ソウ、くわ|mulberry
巣|ソウ、す|nest
掃|ソウ、は-く|sweep
曹|ソウ|cadet
曽|ソウ、（ゾ）|formerly
爽|ソウ、さわ-やか|refreshing
窓|ソウ、まど|window
創|ソウ、つく-る|create
喪|ソウ、も|miss
痩|ソウ、や-せる|get thin
葬|ソウ、ほうむ-る|interment
装|ソウ、ショウ、よそお-う|attire
僧|ソウ|Buddhist priest
想|ソウ、（ソ）|concept
層|ソウ|stratum
総|ソウ|whole
遭|ソウ、あ-う|encounter
槽|ソウ|vat
踪|ソウ|remains
操|ソウ、みさお、あやつ-る|maneuver
燥|ソウ|parch
霜|ソウ、しも|frost
騒|ソウ、さわ-ぐ|boisterous
藻|ソウ、も|seaweed
造|ゾウ、つく-る|create
像|ゾウ|statue
増|ゾウ、ま-す、ふ-える、ふ-やす|increase
憎|ゾウ、にく-む、にく-い、にく-らしい、にく-しみ|hate
蔵|ゾウ、くら|warehouse
贈|ゾウ、（ソウ）、おく-る|presents
臓|ゾウ|entrails
即|ソク|instant
束|ソク、たば|bundle
足|ソク、あし、た-りる、た-る、た-す|foot
促|ソク、うなが-す|stimulate
則|ソク|rule
息|ソク、いき|breath
捉|ソク、とら-える|capture
速|ソク、はや-い、はや-める、はや-まる、すみ-やか|fast
側|ソク、がわ|side
測|ソク、はか-る|fathom
俗|ゾク|vulgar
族|ゾク|tribe
属|ゾク|belong
賊|ゾク|burglar
続|ゾク、つづ-く、つづ-ける|continue
卒|ソツ|graduate
率|ソツ、リツ、ひき-いる|rate
存|ソン、ゾン|suppose
村|ソン、むら|village
孫|ソン、まご|grandchild
尊|ソン、たっと-い、とうと-い、たっと-ぶ、とうと-ぶ|revered
損|ソン、そこ-なう、そこ-ねる|loss
遜|ソン|humble
他|タ、ほか|other
多|タ、おお-い|many
汰|タ|luxury
打|ダ、う-つ|hit
妥|ダ|gentle
唾|ダ、つば|saliva
堕|ダ|degenerate
惰|ダ|lazy
駄|ダ|burdensome
太|タイ、タ、ふと-い、ふと-る|thick
対|タイ、ツイ|opposite
体|タイ、テイ、からだ|body
耐|タイ、た-える|resistant
待|タイ、ま-つ|wait
怠|タイ、おこた-る、なま-ける|neglect
胎|タイ|womb
退|タイ、しりぞ-く、しりぞ-ける|retreat
帯|タイ、お-びる、おび|sash
泰|タイ|peaceful
堆|タイ|piled high
袋|タイ、ふくろ|sack
逮|タイ|apprehend
替|タイ、か-える、か-わる|exchange
貸|タイ、か-す|lend
隊|タイ|group
滞|タイ、とどこお-る|stagnate
態|タイ|condition
戴|タイ|be crowned with
大|ダイ、タイ、おお、おお-きい、おお-いに|large
代|ダイ、タイ、か-わる、か-える、よ、しろ|substitute
台|ダイ、タイ|pedestal
第|ダイ|ordinal number prefix
題|ダイ|topic
滝|たき|waterfall
宅|タク|home
択|タク|choose
沢|タク、さわ|swamp
卓|タク|eminent
拓|タク|clear (the land)
託|タク|consign
濯|タク|laundry
諾|ダク|consent
濁|ダク、にご-る、にご-す|voiced
但|ただ-し|however
達|タツ|attain
脱|ダツ、ぬ-ぐ、ぬ-げる|undress
奪|ダツ、うば-う|rob
棚|たな|shelf
誰|だれ|who (question word)
丹|タン|cinnabar
旦|タン、ダン|daybreak
担|タン、かつ-ぐ、にな-う|shouldering
単|タン|simple
炭|タン、すみ|charcoal
胆|タン|gall bladder
探|タン、さぐ-る、さが-す|grope
淡|タン、あわ-い|thin
短|タン、みじか-い|short
嘆|タン、なげ-く、なげ-かわしい|sigh
端|タン、はし、は、はた|edge
綻|タン、ほころ-びる|rip
誕|タン|nativity
鍛|タン、きた-える|forge
団|ダン、（トン）|group
男|ダン、ナン、おとこ|male
段|ダン|steps
断|ダン、た-つ、ことわ-る|cut off
弾|ダン、ひ-く、はず-む、たま|bullet
暖|ダン、あたた-か、あたた-かい、あたた-まる、あたた-める|warmth
談|ダン|discuss
壇|ダン、（タン）|podium
地|チ、ジ|ground
池|チ、いけ|pond
知|チ、し-る|know
値|チ、ね、あたい|value
恥|チ、は-じる、はじ、は-じらう、は-ずかしい|shame
致|チ、いた-す|(to) do
遅|チ、おく-れる、おく-らす、おそ-い|slow
痴|チ|stupid
稚|チ|immature
置|チ、お-く|put
緻|チ|fine (not coarse)
竹|チク、たけ|bamboo
畜|チク|livestock
逐|チク|pursue
蓄|チク、たくわ-える|amass
築|チク、きず-く|fabricate
秩|チツ|regularity
窒|チツ|plug up
茶|チャ、サ|tea
着|チャク、（ジャク）、き-る、き-せる、つ-く、つ-ける|wear
嫡|チャク|legitimate wife
中|チュウ、（ジュウ）、なか|middle
仲|チュウ、なか|relationship
虫|チュウ、むし|insect
沖|チュウ、おき|open sea
宙|チュウ|mid-air
忠|チュウ|loyalty
抽|チュウ|pluck
注|チュウ、そそ-ぐ|pour
昼|チュウ、ひる|daytime
柱|チュウ、はしら|pillar
衷|チュウ|inmost
酎|チュウ|sake
鋳|チュウ、い-る|casting
駐|チュウ|stop-over
著|チョ、あらわ-す、いちじる-しい|renowned
貯|チョ|savings
丁|チョウ、テイ|ward
弔|チョウ、とむら-う|condolences
庁|チョウ|government office
兆|チョウ、きざ-す、きざ-し|portent, trillion
町|チョウ、まち|town
長|チョウ、なが-い|long
挑|チョウ、いど-む|challenge
帳|チョウ|account book
張|チョウ、は-る|stretch
彫|チョウ、ほ-る|carve
眺|チョウ、なが-める|stare
釣|チョウ、つ-る|angling
頂|チョウ、いただ-く、いただき|place on the head
鳥|チョウ、とり|bird
朝|チョウ、あさ|morning
貼|チョウ、は-る|paste
超|チョウ、こ-える、こ-す|transcend
腸|チョウ|intestines
跳|チョウ、は-ねる、と-ぶ|hop
徴|チョウ|indications
嘲|チョウ、あざけ-る|ridicule
潮|チョウ、しお|tide
澄|チョウ、す-む、す-ます|lucidity
調|チョウ、しら-べる、ととの-う、ととの-える|investigate
聴|チョウ、き-く|listen
懲|チョウ、こ-りる、こ-らす、こ-らしめる|penal
直|チョク、ジキ、ただ-ちに、なお-す、なお-る|straight
勅|チョク|imperial order
捗|チョク|make progress
沈|チン、しず-む、しず-める|sink
珍|チン、めずら-しい|rare
朕|チン|majestic plural
陳|チン|exhibit
賃|チン|fare
鎮|チン、しず-める、しず-まる|tranquilize
追|ツイ、お-う|follow
椎|ツイ|oak
墜|ツイ|crash
通|ツウ、（ツ）、とお-る、とお-す、かよ-う|pass through
痛|ツウ、いた-い、いた-む、いた-める|pain
塚|つか|hillock
漬|つ-ける、つ-かる|pickling
坪|つぼ|two-mat area
爪|つめ、（つま）|claw
鶴|つる|crane
低|テイ、ひく-い、ひく-める、ひく-まる|low
呈|テイ|display
廷|テイ|courts
弟|テイ、（ダイ）、（デ）、おとうと|younger brother
定|テイ、ジョウ、さだ-める、さだ-まる、さだ-か|decide
底|テイ、そこ|bottom
抵|テイ|resist
邸|テイ|residence
亭|テイ|pavilion
貞|テイ|upright
帝|テイ|sovereign
訂|テイ|revise
庭|テイ、にわ|garden
逓|テイ|relay
停|テイ|halt
偵|テイ|spy
堤|テイ、つつみ|dike
提|テイ、さ-げる|present
程|テイ、ほど|extent
艇|テイ|rowboat
締|テイ、し-まる、し-める|tighten
諦|テイ、あきら-める|abandon
泥|デイ、どろ|mud
的|テキ、まと|target
笛|テキ、ふえ|flute
摘|テキ、つ-む|pinch
滴|テキ、しずく、したた-る|drip
適|テキ|suitable
敵|テキ、かたき|enemy
溺|デキ、おぼ-れる|drown
迭|テツ|transfer
哲|テツ|philosophy
鉄|テツ|iron
徹|テツ|penetrate
撤|テツ|remove
天|テン、あめ、（あま）|heaven
典|テン|code
店|テン、みせ|shop
点|テン|point
展|テン|expand
添|テン、そ-える、そ-う|annexed
転|テン、ころ-がる、ころ-げる、ころ-がす、ころ-ぶ|revolve
塡|テン|fill in
田|デン、た|rice paddy
伝|デン、つた-わる、つた-える、つた-う|transmit
殿|デン、テン、との、どの|Mr.
電|デン|electricity
斗|ト|Big Dipper
吐|ト、は-く|spit
妬|ト、ねた-む|jealousy
徒|ト|junior
途|ト|route
都|ト、ツ、みやこ|metropolis
渡|ト、わた-る、わた-す|transit
塗|ト、ぬ-る|paint
賭|ト、か-ける|gamble
土|ド、ト、つち|soil
奴|ド|guy
努|ド、つと-める|toil
度|ド、（ト）、（タク）、たび|degrees
怒|ド、いか-る、おこ-る|angry
刀|トウ、かたな|sword
冬|トウ、ふゆ|winter
灯|トウ、ひ|lamp
当|トウ、あ-たる、あ-てる|hit
投|トウ、な-げる|throw
豆|トウ、（ズ）、まめ|beans
東|トウ、ひがし|east
到|トウ|arrival
逃|トウ、に-げる、に-がす、のが-す、のが-れる|escape
倒|トウ、たお-れる、たお-す|overthrow
凍|トウ、こお-る、こご-える|frozen
唐|トウ、から|T'ang
島|トウ、しま|island
桃|トウ、もも|peach tree
討|トウ、う-つ|chastise
透|トウ、す-く、す-かす、す-ける|transparent
党|トウ|group
悼|トウ、いた-む|lament
盗|トウ、ぬす-む|steal
陶|トウ|pottery
塔|トウ|pagoda
搭|トウ|board
棟|トウ、むね、（むな）|ridgepole
湯|トウ、ゆ|hot water
痘|トウ|pox
登|トウ、ト、のぼ-る|climb
答|トウ、こた-える、こた-え|answer
等|トウ、ひと-しい|class
筒|トウ、つつ|cylinder
統|トウ、す-べる|unite
稲|トウ、いね、（いな）|rice plant
踏|トウ、ふ-む、ふ-まえる|step
糖|トウ|sugar
頭|トウ、ズ、（ト）、あたま、かしら|head
謄|トウ|mimeograph
藤|トウ、ふじ|wisteria
闘|トウ、たたか-う|fight
騰|トウ|inflation
同|ドウ、おな-じ|same
洞|ドウ、ほら|den
胴|ドウ|trunk
動|ドウ、うご-く、うご-かす|move
堂|ドウ|public chamber
童|ドウ、わらべ|juvenile
道|ドウ、（トウ）、みち|road
働|ドウ、はたら-く|work
銅|ドウ|copper
導|ドウ、みちび-く|guide
瞳|ドウ、ひとみ|pupil
峠|とうげ|mountain peak
匿|トク|hide
特|トク|special
得|トク、え-る、う-る|acquire
督|トク|coach
徳|トク|benevolence
篤|トク|fervent
毒|ドク|poison
独|ドク、ひと-り|alone
読|ドク、トク、（トウ）、よ-む|read
栃|（とち）[6]|horse chestnut
凸|トツ|convex
突|トツ、つ-く|stab
届|とど-ける、とど-く|deliver
屯|トン|barracks
豚|トン、ぶた|pork
頓|トン|suddenly
貪|ドン、むさぼ-る|covet
鈍|ドン、にぶ-い、にぶ-る|dull
曇|ドン、くも-る|cloudy weather
丼|どんぶり、（どん）|bowl of food
那|ナ|what
奈|ナ|what
内|ナイ、（ダイ）、うち|inside
梨|なし|pear tree
謎|なぞ|riddle
鍋|なべ|pot
南|ナン、（ナ）、みなみ|south
軟|ナン、やわ-らか、やわ-らかい|soft
難|ナン、かた-い、むずか-しい|difficult
二|ニ、ふた、ふた-つ|two
尼|ニ、あま|nun
弐|ニ|two (falsification prevention)
匂|にお-う|scent
肉|ニク|meat
虹|にじ|rainbow
日|ニチ、ジツ、ひ、か|day
入|ニュウ、い-る、い-れる、はい-る|enter
乳|ニュウ、ちち、ち|milk
尿|ニョウ|urine
任|ニン、まか-せる、まか-す|responsibility
妊|ニン|pregnancy
忍|ニン、しの-ぶ、しの-ばせる|endure
認|ニン、みと-める|recognize
寧|ネイ|rather
熱|ネツ、あつ-い|heat
年|ネン、とし|year
念|ネン|thought
捻|ネン、ひね-る|twist
粘|ネン、ねば-る|sticky
燃|ネン、も-える、も-やす、も-す|burn
悩|ノウ、なや-む、なや-ます|trouble
納|ノウ、（ナッ）、（ナ）、（ナン）、（トウ）、おさ-める、おさ-まる|settlement
能|ノウ|ability
脳|ノウ|brain
農|ノウ|farming
濃|ノウ、こ-い|concentrated
把|ハ|grasp
波|ハ、なみ|wave
派|ハ|sect
破|ハ、やぶ-る、やぶ-れる|rend
覇|ハ|hegemony
馬|バ、うま、（ま）|horse
婆|バ|old woman
罵|バ、ののし-る|insult
拝|ハイ、おが-む|worship
杯|ハイ、さかずき|counter for cupfuls
背|ハイ、せ、せい、そむ-く、そむ-ける|back
肺|ハイ|lungs
俳|ハイ|haiku
配|ハイ、くば-る|distribute
排|ハイ|repudiate
敗|ハイ、やぶ-れる|failure
廃|ハイ、すた-れる、すた-る|abolish
輩|ハイ|comrade
売|バイ、う-る、う-れる|sell
倍|バイ|double
梅|バイ、うめ|ume (Japanese apricot)
培|バイ、つちか-う|cultivate
陪|バイ|obeisance
媒|バイ|mediator
買|バイ、か-う|buy
賠|バイ|compensation
白|ハク、ビャク、しろ、（しら）、しろ-い|white
伯|ハク|chief
拍|ハク、（ヒョウ）|clap
泊|ハク、と-まる、と-める|overnight
迫|ハク、せま-る|urge
剝|ハク、は-がす、は-ぐ、は-がれる、は-げる|peel
舶|ハク|liner
博|ハク、（バク）|Dr.
薄|ハク、うす-い、うす-める、うす-まる、うす-らぐ、うす-れる|dilute
麦|バク、むぎ|wheat
漠|バク|vague
縛|バク、しば-る|truss
爆|バク|explode
箱|はこ|box
箸|はし|chopsticks
畑|はた、はたけ|farm
肌|はだ|texture
八|ハチ、や、や-つ、やっ-つ、（よう）|eight
鉢|ハチ、（ハツ）|bowl
発|ハツ、ホツ|departure
髪|ハツ、かみ|hair of the head
伐|バツ|fell
抜|バツ、ぬ-く、ぬ-ける、ぬ-かす、ぬ-かる|slip out
罰|バツ、バチ|penalty
閥|バツ|clique
反|ハン、（ホン）、（タン）、そ-る、そ-らす|anti-
半|ハン、なか-ば|half
氾|ハン|spread out
犯|ハン、おか-す|crime
帆|ハン、ほ|sail
汎|ハン|pan-
伴|ハン、バン、ともな-う|consort
判|ハン、バン|judge
坂|ハン、さか|slope
阪|ハン|heights
板|ハン、バン、いた|board
版|ハン|printing block
班|ハン|squad
畔|ハン|paddy-ridge
般|ハン|generally
販|ハン|marketing
斑|ハン|blemish
飯|ハン、めし|meal
搬|ハン|conveyor
煩|ハン、（ボン）、わずら-う、わずら-わす|anxiety
頒|ハン|partition
範|ハン|pattern
繁|ハン|luxuriant
藩|ハン|clan
晩|バン|nightfall
番|バン|one's turn
蛮|バン|barbarian
盤|バン|tray
比|ヒ、くら-べる|compare
皮|ヒ、かわ|skin
妃|ヒ|queen
否|ヒ、いな|negate
批|ヒ|criticism
彼|ヒ、かれ、（かの）|he
披|ヒ|expose
肥|ヒ、こ-える、こえ、こ-やす、こ-やし|fertilizer
非|ヒ|negative
卑|ヒ、いや-しい、いや-しむ、いや-しめる|lowly
飛|ヒ、と-ぶ、と-ばす|fly
疲|ヒ、つか-れる|exhausted
秘|ヒ、ひ-める|secret
被|ヒ、こうむ-る|incur
悲|ヒ、かな-しい、かな-しむ|sad
扉|ヒ、とびら|front door
費|ヒ、つい-やす、つい-える|expense
碑|ヒ|tombstone
罷|ヒ|quit
避|ヒ、さ-ける|evade
尾|ビ、お|tail
眉|ビ、（ミ）、まゆ|eyebrow
美|ビ、うつく-しい|beauty
備|ビ、そな-える、そな-わる|provide
微|ビ|delicate
鼻|ビ、はな|nose
膝|ひざ|knee
肘|ひじ|elbow
匹|ヒツ、ひき|equal
必|ヒツ、かなら-ず|without fail
泌|ヒツ、ヒ|ooze
筆|ヒツ、ふで|writing brush
姫|ひめ|princess
百|ヒャク|hundred
氷|ヒョウ、こおり、ひ|ice
表|ヒョウ、おもて、あらわ-す、あらわ-れる|express
俵|ヒョウ、たわら|bag
票|ヒョウ|ballot
評|ヒョウ|evaluate
漂|ヒョウ、ただよ-う|drift
標|ヒョウ|signpost
苗|ビョウ、なえ、（なわ）|seedling
秒|ビョウ|second (part of time)
病|ビョウ、（ヘイ）、や-む、やまい|sick
描|ビョウ、えが-く、か-く|sketch
猫|ビョウ、ねこ|cat
品|ヒン、しな|article
浜|ヒン、はま|seacoast
貧|ヒン、ビン、まず-しい|poor
賓|ヒン|V.I.P.
頻|ヒン|repeatedly
敏|ビン|cleverness
瓶|ビン|flower pot
不|フ、ブ|non-
夫|フ、（フウ）、おっと|husband
父|フ、ちち|father
付|フ、つ-ける、つ-く|attach
布|フ、ぬの|linen
扶|フ|aid
府|フ|urban prefecture
怖|フ、こわ-い|dreadful
阜|（フ）[6]|mound
附|フ|affixed
訃|フ|obituary
負|フ、ま-ける、ま-かす、お-う|lose
赴|フ、おもむ-く|proceed
浮|フ、う-く、う-かれる、う-かぶ、う-かべる|floating
婦|フ|lady
符|フ|token
富|フ、（フウ）、と-む、とみ|rich
普|フ|universal
腐|フ、くさ-る、くさ-れる、くさ-らす|rot
敷|フ、し-く|spread
膚|フ|skin
賦|フ|levy
譜|フ|musical score
侮|ブ、あなど-る|scorn
武|ブ、ム|military
部|ブ|part
舞|ブ、ま-う、まい|dance
封|フウ、ホウ|seal
風|フウ、（フ）、かぜ、（かざ）|wind
伏|フク、ふ-せる、ふ-す|prostrated
服|フク|clothes
副|フク|vice
幅|フク、はば|breadth
復|フク|again
福|フク|luck
腹|フク、はら|abdomen
複|フク|duplicate
覆|フク、おお-う、くつがえ-す、くつがえ-る|capsize
払|フツ、はら-う|pay
沸|フツ、わ-く、わ-かす|seethe
仏|ブツ、ほとけ|Buddha
物|ブツ、モツ、もの|thing
粉|フン、こ、こな|flour
紛|フン、まぎ-れる、まぎ-らす、まぎ-らわす、まぎ-らわしい|distract
雰|フン|atmosphere
噴|フン、ふ-く|erupt
墳|フン|tomb
憤|フン、いきどお-る|aroused
奮|フン、ふる-う|stirred up
分|ブン、フン、ブ、わ-ける、わ-かれる、わ-かる、わ-かつ|part, minute of time
文|ブン、モン、ふみ|writing
聞|ブン、モン、き-く、き-こえる|hear
丙|ヘイ|third class
平|ヘイ、ビョウ、たい-ら、ひら|flat
兵|ヘイ、ヒョウ|soldier
併|ヘイ、あわ-せる|join
並|ヘイ、なみ、なら-べる、なら-ぶ、なら-びに|line-up
柄|ヘイ、がら、え|design
陛|ヘイ|highness
閉|ヘイ、と-じる、と-ざす、し-める、し-まる|closed
塀|ヘイ|fence
幣|ヘイ|cash
弊|ヘイ|abuse
蔽|ヘイ|cover
餅|ヘイ、もち|mochi rice cake
米|ベイ、マイ、こめ|rice
壁|ヘキ、かべ|wall
璧|ヘキ|sphere
癖|ヘキ、くせ|mannerism
別|ベツ、わか-れる|separate
蔑|ベツ、さげす-む|ignore
片|ヘン、かた|one-sided
辺|ヘン、あた-り、べ|environs
返|ヘン、かえ-す、かえ-る|return
変|ヘン、か-わる、か-える|change
偏|ヘン、かたよ-る|partial
遍|ヘン|everywhere
編|ヘン、あ-む|compile
弁|undefined|undefined
辛|undefined|undefined
5|undefined|undefined
便|ベン、ビン、たよ-り|convenience
勉|ベン|exertion
歩|ホ、ブ、（フ）、ある-く、あゆ-む|walk
保|ホ、たも-つ|preserve
哺|ホ|suckle
捕|ホ、と-らえる、と-らわれる、と-る、つか-まえる、つか-まる|catch
補|ホ、おぎな-う|supplement
舗|ホ|pavement
母|ボ、はは|mother
募|ボ、つの-る|recruit
墓|ボ、はか|grave
慕|ボ、した-う|pining
暮|ボ、く-れる、く-らす|livelihood
簿|ボ|register
方|ホウ、かた|direction
包|ホウ、つつ-む|wrap
芳|ホウ、かんば-しい|perfume
邦|ホウ|home country
奉|ホウ、（ブ）、たてまつ-る|observance
宝|ホウ、たから|treasure
抱|ホウ、だ-く、いだ-く、かか-える|embrace
放|ホウ、はな-す、はな-つ、はな-れる、ほう-る|release
法|ホウ、（ハッ）、（ホッ）|method
泡|ホウ、あわ|bubbles
胞|ホウ|placenta
俸|ホウ|salary
倣|ホウ、なら-う|emulate
峰|ホウ、みね|summit
砲|ホウ|cannon
崩|ホウ、くず-れる、くず-す|crumble
訪|ホウ、おとず-れる、たず-ねる|visit
報|ホウ、むく-いる|report
蜂|ホウ、はち|bee
豊|ホウ、ゆた-か|bountiful
飽|ホウ、あ-きる、あ-かす|sated
褒|ホウ、ほ-める|praise
縫|ホウ、ぬ-う|sew
亡|ボウ、（モウ）、な-い|deceased
乏|ボウ、とぼ-しい|scarce
忙|ボウ、いそが-しい|busy
坊|ボウ、（ボッ）|boy
妨|ボウ、さまた-げる|disturb
忘|ボウ、わす-れる|forget
防|ボウ、ふせ-ぐ|prevent
房|ボウ、ふさ|tassel
肪|ボウ|obese
某|ボウ|so-and-so
冒|ボウ、おか-す|risk
剖|ボウ|divide
紡|ボウ、つむ-ぐ|spinning
望|ボウ、モウ、のぞ-む|hope
傍|ボウ、かたわ-ら|bystander
帽|ボウ|cap
棒|ボウ|rod
貿|ボウ|trade
貌|ボウ|appearance
暴|ボウ、（バク）、あば-く、あば-れる|outburst
膨|ボウ、ふく-らむ、ふく-れる|swell
謀|ボウ、（ム）、はか-る|conspire
頰|ほお|cheek
北|ホク、きた|north
木|ボク、モク、き、（こ）|tree
朴|ボク|crude
牧|ボク、まき|breed
睦|ボク|harmonious
僕|ボク|me
墨|ボク、すみ|black ink
撲|ボク|slap
没|ボツ|drown
勃|ボツ|rise
堀|ほり|ditch
本|ホン、もと|book
奔|ホン|bustle
翻|ホン、ひるがえ-る、ひるがえ-す|flip
凡|ボン、（ハン）|mediocre
盆|ボン|basin
麻|マ、あさ|hemp
摩|マ|chafe
磨|マ、みが-く|grind
魔|マ|witch
毎|マイ|every
妹|マイ、いもうと|younger sister
枚|マイ|sheet of...
昧|マイ|foolish
埋|マイ、う-める、う-まる、う-もれる|bury
幕|マク、バク|curtain
膜|マク|membrane
枕|まくら|pillow
又|また|or again
末|マツ、バツ、すえ|end
抹|マツ|rub
万|マン、バン|ten thousand
満|マン、み-ちる、み-たす|full
慢|マン|ridicule
漫|マン|cartoon
未|ミ|not yet
味|ミ、あじ、あじ-わう|flavor
魅|ミ|fascination
岬|みさき|headland
密|ミツ|secrecy
蜜|ミツ|honey
脈|ミャク|vein
妙|ミョウ|exquisite
民|ミン、たみ|people
眠|ミン、ねむ-る、ねむ-い|sleep
矛|ム、ほこ|halberd
務|ム、つと-める、つと-まる|duty
無|ム、ブ、な-い|nothing
夢|ム、ゆめ|dream
霧|ム、きり|fog
娘|むすめ|daughter
名|メイ、ミョウ、な|name
命|メイ、ミョウ、いのち|fate
明|メイ、ミョウ、あ-かり、あか-るい、あか-るむ、あか-らむ、あき-らか、あ-ける、あ-く、あ-くる、あ-かす|bright
迷|メイ、まよ-う|astray
冥|メイ、ミョウ|dark
盟|メイ|alliance
銘|メイ|inscription
鳴|メイ、な-く、な-る、な-らす|chirp
滅|メツ、ほろ-びる、ほろ-ぼす|destroy
免|メン、まぬか-れる|excuse
面|メン、おも、おもて、つら|face
綿|メン、わた|cotton
麺|メン|noodles
茂|モ、しげ-る|overgrown
模|モ、ボ|imitation
毛|モウ、け|hair
妄|モウ、ボウ|delusion
盲|モウ|blind
耗|モウ、（コウ）|decrease
猛|モウ|fierce
網|モウ、あみ|netting
目|モク、（ボク）、め、（ま）|eye
黙|モク、だま-る|silence
門|モン、かど|gates
紋|モン|family crest
問|モン、と-う、と-い、（とん）|question
冶|ヤ|melting
夜|ヤ、よ、よる|night
野|ヤ、の|field
弥|や|all the more
厄|ヤク|unlucky
役|ヤク、エキ|service
約|ヤク|promise
訳|ヤク、わけ|translate
薬|ヤク、くすり|medicine
躍|ヤク、おど-る|leap
闇|やみ|darkness
由|ユ、ユウ、（ユイ）、よし|reason
油|ユ、あぶら|oil
喩|ユ|metaphor
愉|ユ|pleasure
諭|ユ、さと-す|rebuke
輸|ユ|transport
癒|ユ、い-える、い-やす|healing
唯|ユイ、（イ）|solely
友|ユウ、とも|friend
有|ユウ、ウ、あ-る|have
勇|ユウ、いさ-む|courage
幽|ユウ|seclude
悠|ユウ|permanence
郵|ユウ|mail
湧|ユウ、わ-く|boil
猶|ユウ|furthermore
裕|ユウ|abundant
遊|ユウ、（ユ）、あそ-ぶ|play
雄|ユウ、お、おす|male
誘|ユウ、さそ-う|entice
憂|ユウ、うれ-える、うれ-い、う-い|melancholy
融|ユウ|dissolve
優|ユウ、やさ-しい、すぐ-れる|superior
与|ヨ、あた-える|give
予|ヨ|in advance
余|ヨ、あま-る、あま-す|leave over
誉|ヨ、ほま-れ|reputation
預|ヨ、あず-ける、あず-かる|deposit
幼|ヨウ、おさな-い|infancy
用|ヨウ、もち-いる|use
羊|ヨウ、ひつじ|sheep
妖|ヨウ、あや-しい|bewitching
洋|ヨウ|ocean
要|ヨウ、かなめ、い-る|need
容|ヨウ|contain
庸|ヨウ|commonplace
揚|ヨウ、あ-げる、あ-がる|hoist
揺|ヨウ、ゆ-れる、ゆ-る、ゆ-らぐ、ゆ-るぐ、ゆ-する、ゆ-さぶる、ゆ-すぶる|swing
葉|ヨウ、は|leaf
陽|ヨウ|sunshine
溶|ヨウ、と-ける、と-かす、と-く|melt
腰|ヨウ、こし|loins
様|ヨウ、さま|formal title
瘍|ヨウ|boil (medical)
踊|ヨウ、おど-る、おど-り|jump
窯|ヨウ、かま|kiln
養|ヨウ、やしな-う|foster
擁|ヨウ|embrace
謡|ヨウ、うたい、うた-う|noh chanting
曜|ヨウ|day of the week
抑|ヨク、おさ-える|repress
沃|ヨク|fertility
浴|ヨク、あ-びる、あ-びせる|bathe
欲|ヨク、ほっ-する、ほ-しい|longing
翌|ヨク|the following
翼|ヨク、つばさ|wing
拉|ラ|crush
裸|ラ、はだか|naked
羅|ラ|gauze
来|ライ、く-る、きた-る、きた-す|come
雷|ライ、かみなり|thunder
頼|ライ、たの-む、たの-もしい、たよ-る|trust
絡|ラク、から-む、から-まる、から-める|entwine
落|ラク、お-ちる、お-とす|fall
酪|ラク|dairy products
辣|ラツ|bitter
乱|ラン、みだ-れる、みだ-す|riot
卵|ラン、たまご|egg
覧|ラン|perusal
濫|ラン|excessive
藍|ラン、あい|indigo
欄|ラン|column
吏|リ|officer
利|リ、き-く|profit
里|リ、さと|village
理|リ|reason
痢|リ|diarrhea
裏|リ、うら|back
履|リ、は-く|footgear
璃|リ|glassy
離|リ、はな-れる、はな-す|detach
陸|リク|land
立|リツ、（リュウ）、た-つ、た-てる|stand up
律|リツ、（リチ）|law
慄|リツ|fear
略|リャク|abbreviation
柳|リュウ、やなぎ|willow
流|リュウ、（ル）、なが-れる、なが-す|stream
留|リュウ、（ル）、と-める、と-まる|detain
竜|リュウ、たつ|dragon
粒|リュウ、つぶ|grains
隆|リュウ|hump
硫|リュウ|sulphur
侶|リョ|companion
旅|リョ、たび|trip
虜|リョ|captive
慮|リョ|prudence
了|リョウ|finish
両|リョウ|both
良|リョウ、よ-い|good
料|リョウ|fee
涼|リョウ、すず-しい、すず-む|refreshing
猟|リョウ|game-hunting
陵|リョウ、みささぎ|mausoleum
量|リョウ、はか-る|quantity
僚|リョウ|colleague
領|リョウ|territory
寮|リョウ|dormitory
療|リョウ|heal
瞭|リョウ|clear
糧|リョウ、（ロウ）、かて|provisions
力|リョク、リキ、ちから|power
緑|リョク、（ロク）、みどり|green
林|リン、はやし|woods
厘|リン|thousandth
倫|リン|ethics
輪|リン、わ|wheel
隣|リン、とな-る、となり|neighboring
臨|リン、のぞ-む|look to
瑠|ル|lapis lazuli
涙|ルイ、なみだ|tears
累|ルイ|accumulate
塁|ルイ|bases
類|ルイ、たぐ-い|sort
令|レイ|orders
礼|レイ、ライ|thanks
冷|レイ、つめ-たい、ひ-える、ひ-や、ひ-やす、ひ-やかす、さ-める、さ-ます|cool
励|レイ、はげ-む、はげ-ます|encourage
戻|レイ、もど-す、もど-る|re-
例|レイ、たと-える|example
鈴|レイ、リン、すず|small bell
零|レイ|zero
霊|レイ、リョウ、たま|spirits
隷|レイ|slave
齢|レイ|age
麗|レイ、うるわ-しい|lovely
暦|レキ、こよみ|calendar
歴|レキ|curriculum
列|レツ|row
劣|レツ、おと-る|inferiority
烈|レツ|ardent
裂|レツ、さ-く、さ-ける|split
恋|レン、こ-う、こい、こい-しい|romance
連|レン、つら-なる、つら-ねる、つ-れる|take along
廉|レン|bargain
練|レン、ね-る|practice
錬|レン|tempering
呂|ロ|spine
炉|ロ|hearth
賂|ロ|bribe
路|ロ、じ|road
露|ロ、（ロウ）、つゆ|dew
老|ロウ、お-いる、ふ-ける|old man
労|ロウ|labour
弄|ロウ、もてあそ-ぶ|tamper with
郎|ロウ|son
朗|ロウ、ほが-らか|melodious
浪|ロウ|wandering
廊|ロウ|corridor
楼|ロウ|watchtower
漏|ロウ、も-る、も-れる、も-らす|leak
籠|ロウ、かご、こ-もる|basket
六|ロク、む、む-つ、むっ-つ、（むい）|six
録|ロク|record
麓|ロク、ふもと|foot of a mountain
論|ロン|theory
和|ワ、（オ）、やわ-らぐ、やわ-らげる、なご-む、なご-やか|peace
話|ワ、はな-す、はなし|talk
賄|ワイ、まかな-う|bribe
脇|わき|aside
惑|ワク、まど-う|beguile
枠|わく|frame
湾|ワン|gulf
腕|ワン、うで|arm